Account No. : ,0021101300006585

No.,Post Date,Post Time,Eff Date,Eff Time,Description,Amount,,Balance,Reference No,
,,,,,,Debit,Credit,,
1,01/08/2019,08:08:55,01/08/2019,08:08:55,0247 UKT 1801618126 0819/0017003        ,0.00,9300000,10584910257.29,19080100170030000002,
2,01/08/2019,08:52:20,01/08/2019,08:52:20,0247 UKT 1801618062 0819/0008219        ,0.00,10300000,10595210257.29,19080100082190000027,
3,01/08/2019,08:53:45,01/08/2019,08:53:45,0247 UKT 1801617159 0819/0018000        ,0.00,4000000,10599210257.29,19080100180000000006,
4,01/08/2019,09:00:51,01/08/2019,09:00:51,0247 UKT 1307618020 0819/0010960        ,0.00,4150000,10603360257.29,19080100109600000017,
5,01/08/2019,09:05:23,01/08/2019,09:05:23,0247 UKT 1308617013 0819/0008219        ,0.00,4150000,10607510257.29,19080100082190000029,
6,01/08/2019,09:11:53,01/08/2019,09:11:53,0247 UKT 1303617044 0819/0012491        ,0.00,3950000,10611460257.29,19080100124910000010,
7,01/08/2019,09:21:22,01/08/2019,09:21:22,0247 UKT 1801618072 0819/0006168        ,0.00,6200000,10617660257.29,19080100061680000007,
8,01/08/2019,09:25:57,01/08/2019,09:25:57,0247 UKT 1107617122 0819/0012882        ,0.00,3000000,10620660257.29,19080100128820000022,
9,01/08/2019,09:31:26,01/08/2019,09:31:26,0247 UKT 1801618020 0819/0009757        ,0.00,8200000,10628860257.29,19080100097570000053,
10,01/08/2019,09:34:05,01/08/2019,09:34:05,0247 UKT 1801617115 0819/0007222        ,0.00,4000000,10632860257.29,19080100072220000017,
11,01/08/2019,09:34:46,01/08/2019,09:34:46,0247 UKT 1301617038 0819/0018015        ,0.00,6000000,10638860257.29,19080100180150000018,
12,01/08/2019,09:35:57,01/08/2019,09:35:57,0247 UKT 1601617151 0819/0008941        ,0.00,4700000,10643560257.29,19080100089410000094,
13,01/08/2019,09:49:46,01/08/2019,09:49:46,0247 UKT 1102617104 0819/0017978        ,0.00,5100000,10648660257.29,19080100179780000076,
14,01/08/2019,10:04:37,01/08/2019,10:04:37,0247 UKT 1602617101 0819/0008594        ,0.00,2700000,10651360257.29,19080100085940000024,
15,01/08/2019,10:05:31,01/08/2019,10:05:31,0247 UKT 1308617011 0819/0008219        ,0.00,6250000,10657610257.29,19080100082190000053,
16,01/08/2019,10:06:23,01/08/2019,10:06:23,0247 UKT 1602617032 0819/0008594        ,0.00,3400000,10661010257.29,19080100085940000026,
17,01/08/2019,10:07:28,01/08/2019,10:07:28,0247 UKT 1304617052 0819/0012949        ,0.00,6200000,10667210257.29,19080100129490000033,
18,01/08/2019,10:07:37,01/08/2019,10:07:37,0247 UKT 1801617307 0819/0008219        ,0.00,4000000,10671210257.29,19080100082190000056,
19,01/08/2019,10:11:14,01/08/2019,10:11:14,0247 UKT 1102618036 0819/0016525        ,0.00,5100000,10676310257.29,19080100165250000030,
20,01/08/2019,10:20:45,01/08/2019,10:20:45,0247 UKT 1103618057 0819/0007248        ,0.00,5300000,10681610257.29,19080100072480000040,
21,01/08/2019,10:22:23,01/08/2019,10:22:23,0247 UKT 1304617018 0819/0016541        ,0.00,3950000,10685560257.29,19080100165410000090,
22,01/08/2019,10:29:25,01/08/2019,10:29:25,0247 UKT 1801617035 0819/0013056        ,0.00,4000000,10689560257.29,19080100130560000059,
23,01/08/2019,10:31:21,01/08/2019,10:31:21,0247 UKT 1105617057 0819/0008163        ,0.00,1000000,10690560257.29,19080100081630000036,
24,01/08/2019,10:33:57,01/08/2019,10:33:57,0247 UKT                                ,0.00,7500000,10698060257.29,19080199452010656679,
25,01/08/2019,10:45:06,01/08/2019,10:45:06,0247 UKT 1203617074 0819/0012249        ,0.00,3700000,10701760257.29,19080100122490000044,
26,01/08/2019,10:48:13,01/08/2019,10:48:13,0247 UKT 1208618014 0819/0013791        ,0.00,4500000,10706260257.29,19080100137910000134,
27,01/08/2019,10:49:30,01/08/2019,10:49:30,0247 UKT 1304617060 0819/0012491        ,0.00,3950000,10710210257.29,19080100124910000041,
28,01/08/2019,11:01:43,01/08/2019,11:01:43,0247 UKT 1801617255 0819/0018227        ,0.00,8200000,10718410257.29,19080100182270000053,
29,01/08/2019,11:03:05,01/08/2019,11:03:05,0247 UKT 1801617236 0819/0017988        ,0.00,6200000,10724610257.29,19080100179880000060,
30,01/08/2019,11:05:08,01/08/2019,11:05:08,0247 UKT 1801617209 0819/0012246        ,0.00,4000000,10728610257.29,19080100122460000125,
31,01/08/2019,11:15:25,01/08/2019,11:15:25,0247 UKT 1801617072 0819/0010403        ,0.00,4000000,10732610257.29,19080100104030000186,
32,01/08/2019,11:17:43,01/08/2019,11:17:43,0247 UKT 1308617068 0819/0009779        ,0.00,4150000,10736760257.29,19080100097790000140,
33,01/08/2019,11:21:13,01/08/2019,11:21:13,0247 UKT 1102617021 0819/0016488        ,0.00,3900000,10740660257.29,19080100164880000016,
34,01/08/2019,11:26:54,01/08/2019,11:26:54,0247 UKT 1301617010 0819/0016670        ,0.00,6000000,10746660257.29,19080100166700000022,
35,01/08/2019,11:29:36,01/08/2019,11:29:36,0247 UKT 1303618036 0819/0016527        ,0.00,3950000,10750610257.29,19080100165270000030,
36,01/08/2019,11:34:04,01/08/2019,11:34:04,0247 UKT 1104617076 0819/0006635        ,0.00,3000000,10753610257.29,19080100066350000101,
37,01/08/2019,11:34:25,01/08/2019,11:34:25,0247 UKT 1101617065 0819/0013482        ,0.00,4000000,10757610257.29,19080100134820000061,
38,01/08/2019,11:49:24,01/08/2019,11:49:24,0247 UKT 1106617066 0819/0008219        ,0.00,5100000,10762710257.29,19080100082190000140,
39,01/08/2019,11:51:07,01/08/2019,11:51:07,0247 UKT 1314617035 0819/0008225        ,0.00,7300000,10770010257.29,19080100082250000069,
40,01/08/2019,11:52:17,01/08/2019,11:52:17,0247 UKT 1107617123 0819/0013062        ,0.00,5800000,10775810257.29,19080100130620000148,
41,01/08/2019,11:55:43,01/08/2019,11:55:43,0247 UKT 1801617222 0819/0008188        ,0.00,8200000,10784010257.29,19080100081880000069,
42,01/08/2019,11:57:27,01/08/2019,11:57:27,0247 UKT 1302618028 0819/0013077        ,0.00,3800000,10787810257.29,19080100130770000045,
43,01/08/2019,12:21:23,01/08/2019,12:21:23,0247 UKT 1213617013 0819/0008219        ,0.00,500000,10788310257.29,19080100082190000144,
44,01/08/2019,12:50:44,01/08/2019,12:50:44,0247 UKT 1106618011 0819/0013437        ,0.00,3000000,10791310257.29,19080100134370000049,
45,01/08/2019,12:53:34,01/08/2019,12:53:34,0247 UKT 1104617079 0819/0013482        ,0.00,5300000,10796610257.29,19080100134820000069,
46,01/08/2019,13:01:50,01/08/2019,13:01:50,0247 UKT 1211617007 0819/0008219        ,0.00,1000000,10797610257.29,19080100082190000147,
47,01/08/2019,13:08:32,01/08/2019,13:08:32,0247 UKT 1801617144 0819/0008219        ,0.00,10300000,10807910257.29,19080100082190000152,
48,01/08/2019,13:10:31,01/08/2019,13:10:31,0247 UKT 1801618024 0819/0008219        ,0.00,4000000,10811910257.29,19080100082190000154,
49,01/08/2019,13:11:51,01/08/2019,13:11:51,0247 UKT 1211618015 0819/0016441        ,0.00,5600000,10817510257.29,19080100164410000093,
50,01/08/2019,13:13:09,01/08/2019,13:13:09,0247 UKT 1305618030 0819/0016999        ,0.00,6200000,10823710257.29,19080100169990000015,
51,01/08/2019,13:19:18,01/08/2019,13:19:18,0247 UKT 1801617050 0819/0016716        ,0.00,6200000,10829910257.29,19080100167160000091,
52,01/08/2019,13:26:39,01/08/2019,13:26:39,0247 UKT 1208618017 0819/0013447        ,0.00,1000000,10830910257.29,19080100134470000094,
53,01/08/2019,13:30:12,01/08/2019,13:30:12,0247 UKT 1106618004 0819/0011549        ,0.00,3000000,10833910257.29,19080100115490000042,
54,01/08/2019,13:36:32,01/08/2019,13:36:32,0247 UKT 1102617113 0819/0018024        ,0.00,3000000,10836910257.29,19080100180240000064,
55,01/08/2019,13:39:05,01/08/2019,13:39:05,0247 UKT 1801617228 0819/0017974        ,0.00,7200000,10844110257.29,19080100179740000080,
56,01/08/2019,13:53:46,01/08/2019,13:53:46,0247 UKT 1107617133 0819/0016659        ,0.00,4500000,10848610257.29,19080100166590000159,
57,01/08/2019,13:57:17,01/08/2019,13:57:17,0247 UKT 1207617044 0819/0016488        ,0.00,7400000,10856010257.29,19080100164880000050,
58,01/08/2019,13:58:35,01/08/2019,13:58:35,0247 UKT 1102617056 0819/0010413        ,0.00,3900000,10859910257.29,19080100104130000036,
59,01/08/2019,14:01:17,01/08/2019,14:01:17,0247 UKT 1801617122 0819/0008219        ,0.00,4000000,10863910257.29,19080100082190000186,
60,01/08/2019,14:13:23,01/08/2019,14:13:23,0247 UKT 1102617060 0819/0009593        ,0.00,5100000,10869010257.29,19080100095930000098,
61,01/08/2019,14:15:33,01/08/2019,14:15:33,0247 UKT 1801617053 0819/0013056        ,0.00,6200000,10875210257.29,19080100130560000088,
62,01/08/2019,14:15:41,01/08/2019,14:15:41,0247 UKT 1107617142 0819/0016614        ,0.00,3900000,10879110257.29,19080100166140000206,
63,01/08/2019,14:17:08,01/08/2019,14:17:08,0247 UKT 1202617004 0819/0009621        ,0.00,3900000,10883010257.29,19080100096210000228,
64,01/08/2019,14:32:50,01/08/2019,14:32:50,0247 UKT 1206617034 0819/0008219        ,0.00,4500000,10887510257.29,19080100082190000191,
65,01/08/2019,14:50:02,01/08/2019,14:50:02,0247 UKT 1801617059 0819/0012484        ,0.00,6200000,10893710257.29,19080100124840000147,
66,01/08/2019,14:54:37,01/08/2019,14:54:37,0247 UKT 1801618133 0819/0008237        ,0.00,8200000,10901910257.29,19080100082370000036,
67,01/08/2019,15:00:20,01/08/2019,15:00:20,0247 UKT                                ,0.00,5200000,10907110257.29,19080199603030947245,
68,01/08/2019,15:25:38,01/08/2019,15:25:38,0247 UKT 1308617016 0819/0016529        ,0.00,4150000,10911260257.29,19080100165290000232,
69,01/08/2019,16:21:51,01/08/2019,16:21:51,0247 UKT                                ,0.00,6700000,10917960257.29,19080199204040736542,
70,01/08/2019,19:27:09,01/08/2019,19:27:09,0247 UKT                                ,0.00,6200000,10924160257.29,19080199437010450806,
71,02/08/2019,08:01:43,02/08/2019,08:01:43,0247 UKT                                ,0.00,4500000,10928660257.29,19080299014260944141,
72,02/08/2019,08:04:56,02/08/2019,08:04:56,0247 UKT 1801618100 0819/0011916        ,0.00,9300000,10937960257.29,19080200119160000027,
73,02/08/2019,08:11:38,02/08/2019,08:11:38,0247 UKT 1801618010 0819/0018028        ,0.00,4000000,10941960257.29,19080200180280000002,
74,02/08/2019,08:17:29,02/08/2019,08:17:29,0247 UKT 1304617002 0819/0008294        ,0.00,7500000,10949460257.29,19080200082940000015,
75,02/08/2019,08:18:17,02/08/2019,08:18:17,0247 UKT 1211617040 0819/0007894        ,0.00,5900000,10955360257.29,19080200078940000003,
76,02/08/2019,08:20:24,02/08/2019,08:20:24,0247 UKT 1801618115 0819/0013065        ,0.00,4000000,10959360257.29,19080200130650000002,
77,02/08/2019,08:34:41,02/08/2019,08:34:41,0247 UKT 1801617032 0819/0008264        ,0.00,9300000,10968660257.29,19080200082640000007,
78,02/08/2019,08:35:06,02/08/2019,08:35:06,0247 UKT 1801617102 0819/0011930        ,0.00,4000000,10972660257.29,19080200119300000006,
79,02/08/2019,08:45:55,02/08/2019,08:45:55,0247 UKT 1303618007 0819/0008219        ,0.00,9000000,10981660257.29,19080200082190000050,
80,02/08/2019,08:46:27,02/08/2019,08:46:27,0247 UKT 1602617085 0819/0013056        ,0.00,5700000,10987360257.29,19080200130560000007,
81,02/08/2019,08:50:38,02/08/2019,08:50:38,0247 UKT 1914190335528 0819/0008219     ,0.00,6500000,10993860257.29,19080200082190000054,
82,02/08/2019,08:56:43,02/08/2019,08:56:43,0247 UKT 1602617041 0819/0008594        ,0.00,4700000,10998560257.29,19080200085940000018,
83,02/08/2019,09:02:19,02/08/2019,09:02:19,0247 UKT 1313618015 0819/0016584        ,0.00,1000000,10999560257.29,19080200165840000036,
84,02/08/2019,09:03:10,02/08/2019,09:03:10,0247 UKT 1801617295 0819/0016997        ,0.00,9300000,11008860257.29,19080200169970000008,
85,02/08/2019,09:03:18,02/08/2019,09:03:18,0247 UKT 1801617134 0819/0008588        ,0.00,7200000,11016060257.29,19080200085880000067,
86,02/08/2019,09:04:20,02/08/2019,09:04:20,0247 UKT 1801617023 0819/0011801        ,0.00,10300000,11026360257.29,19080200118010000033,
87,02/08/2019,09:11:35,02/08/2019,09:11:35,0247 UKT 1308618064 0819/0011549        ,0.00,6250000,11032610257.29,19080200115490000026,
88,02/08/2019,09:12:24,02/08/2019,09:12:24,0247 UKT                                ,0.00,4000000,11036610257.29,19080299273010520771,
89,02/08/2019,09:14:57,02/08/2019,09:14:57,0247 UKT 1105617064 0819/0008219        ,0.00,5100000,11041710257.29,19080200082190000059,
90,02/08/2019,09:26:01,02/08/2019,09:26:01,0247 UKT 1304617035 0819/0017789        ,0.00,3950000,11045660257.29,19080200177890000033,
91,02/08/2019,09:27:37,02/08/2019,09:27:37,0247 UKT 1801617191 0819/0008219        ,0.00,4000000,11049660257.29,19080200082190000067,
92,02/08/2019,09:29:00,02/08/2019,09:29:00,0247 UKT 1801617266 0819/0016439        ,0.00,8200000,11057860257.29,19080200164390000013,
93,02/08/2019,09:34:46,02/08/2019,09:34:46,0247 UKT 1201618041 0819/0017772        ,0.00,4000000,11061860257.29,19080200177720000011,
94,02/08/2019,09:34:53,02/08/2019,09:34:53,0247 UKT 1801617253 0819/0009772        ,0.00,7200000,11069060257.29,19080200097720000062,
95,02/08/2019,09:37:54,02/08/2019,09:37:54,0247 UKT 1105618033 0819/0016989        ,0.00,500000,11069560257.29,19080200169890000077,
96,02/08/2019,09:39:13,02/08/2019,09:39:13,0247 UKT 1308618045 0819/0017770        ,0.00,6250000,11075810257.29,19080200177700000048,
97,02/08/2019,09:39:16,02/08/2019,09:39:16,0247 UKT 1107617070 0819/0017012        ,0.00,6400000,11082210257.29,19080200170120000064,
98,02/08/2019,09:39:28,02/08/2019,09:39:28,0247 UKT 1801617189 0819/0016544        ,0.00,4000000,11086210257.29,19080200165440000033,
99,02/08/2019,09:40:37,02/08/2019,09:40:37,0247 UKT 1801617235 0819/0017770        ,0.00,8200000,11094410257.29,19080200177700000050,
100,02/08/2019,09:55:31,02/08/2019,09:55:31,0247 UKT 1201617017 0819/0013765        ,0.00,4000000,11098410257.29,19080200137650000011,
101,02/08/2019,09:56:28,02/08/2019,09:56:28,0247 UKT 1801617108 0819/0010956        ,0.00,4000000,11102410257.29,19080200109560000096,
102,02/08/2019,10:00:13,02/08/2019,10:00:13,0247 UKT 1307618013 0819/0006789        ,0.00,4150000,11106560257.29,19080200067890000021,
103,02/08/2019,10:02:18,02/08/2019,10:02:18,0247 UKT 1801618052 0819/0008244        ,0.00,4000000,11110560257.29,19080200082440000013,
104,02/08/2019,10:06:03,02/08/2019,10:06:03,0247 UKT 1104617078 0819/0012240        ,0.00,1000000,11111560257.29,19080200122400000029,
105,02/08/2019,10:10:40,02/08/2019,10:10:40,0247 UKT 1304618059 0819/0008219        ,0.00,5200000,11116760257.29,19080200082190000069,
106,02/08/2019,10:19:31,02/08/2019,10:19:31,0247 UKT 1601618101 0819/0008219        ,0.00,4700000,11121460257.29,19080200082190000071,
107,02/08/2019,10:23:58,02/08/2019,10:23:58,0247 UKT 1107617063 0819/0012234        ,0.00,5800000,11127260257.29,19080200122340000111,
108,02/08/2019,10:45:43,02/08/2019,10:45:43,0247 UKT                                ,0.00,4500000,11131760257.29,19080299166020382204,
109,02/08/2019,10:45:57,02/08/2019,10:45:57,0247 UKT 1801618112 0819/0008272        ,0.00,9300000,11141060257.29,19080200082720000067,
110,02/08/2019,10:49:35,02/08/2019,10:49:35,0247 UKT 1801617030 0819/0016615        ,0.00,8200000,11149260257.29,19080200166150000016,
111,02/08/2019,10:51:25,02/08/2019,10:51:25,0247 UKT 1801617015 0819/0013080        ,0.00,500000,11149760257.29,19080200130800000072,
112,02/08/2019,10:53:58,02/08/2019,10:53:58,0247 UKT 1801617167 0819/0017017        ,0.00,6200000,11155960257.29,19080200170170000072,
113,02/08/2019,11:00:25,02/08/2019,11:00:25,0247 UKT 1922190337634 0819/0008219     ,0.00,6700000,11162660257.29,19080200082190000079,
114,02/08/2019,11:00:46,02/08/2019,11:00:46,0247 UKT 1801618043 0819/0008236        ,0.00,6200000,11168860257.29,19080200082360000121,
115,02/08/2019,11:06:06,02/08/2019,11:06:06,0247 UKT 1801617257 0819/0016529        ,0.00,8200000,11177060257.29,19080200165290000124,
116,02/08/2019,11:06:58,02/08/2019,11:06:58,0247 UKT 1801617055 0819/0013785        ,0.00,6200000,11183260257.29,19080200137850000056,
117,02/08/2019,11:08:36,02/08/2019,11:08:36,0247 UKT 1801617182 0819/0006827        ,0.00,8200000,11191460257.29,19080200068270000030,
118,02/08/2019,11:11:44,02/08/2019,11:11:44,0247 UKT 1102617110 0819/0008219        ,0.00,1000000,11192460257.29,19080200082190000082,
119,02/08/2019,11:16:45,02/08/2019,11:16:45,0247 UKT 1801618011 0819/0008946        ,0.00,8200000,11200660257.29,19080200089460000086,
120,02/08/2019,11:18:13,02/08/2019,11:18:13,0247 UKT 1202617020 0819/0008253        ,0.00,5200000,11205860257.29,19080200082530000016,
121,02/08/2019,11:19:06,02/08/2019,11:19:06,0247 UKT 1801617276 0819/0016658        ,0.00,8200000,11214060257.29,19080200166580000023,
122,02/08/2019,11:28:57,02/08/2019,11:28:57,0247 UKT 1302618047 0819/0013765        ,0.00,4300000,11218360257.29,19080200137650000040,
123,02/08/2019,11:32:13,02/08/2019,11:32:13,0247 UKT 1304618060 0819/0013765        ,0.00,3950000,11222310257.29,19080200137650000042,
124,02/08/2019,11:49:45,02/08/2019,11:49:45,0247 UKT 1801618060 0819/0008220        ,0.00,4000000,11226310257.29,19080200082200000040,
125,02/08/2019,11:57:59,02/08/2019,11:57:59,0247 UKT 1801617256 0819/0008186        ,0.00,7200000,11233510257.29,19080200081860000004,
126,02/08/2019,12:31:59,02/08/2019,12:31:59,0247 UKT                                ,0.00,3800000,11237310257.29,19080299113810188954,
127,02/08/2019,12:41:55,02/08/2019,12:41:55,0247 UKT                                ,0.00,3800000,11241110257.29,19080299113810259849,
128,02/08/2019,12:44:12,02/08/2019,12:44:12,0247 UKT                                ,0.00,1000000,11242110257.29,19080299113810276591,
129,02/08/2019,12:52:12,02/08/2019,12:52:12,0247 UKT                                ,0.00,8000000,11250110257.29,19080299310010337724,
130,02/08/2019,13:01:36,02/08/2019,13:01:36,0247 UKT 1304618066 0819/0009593        ,0.00,6200000,11256310257.29,19080200095930000083,
131,02/08/2019,13:08:04,02/08/2019,13:08:04,0247 UKT 1304618058 0819/0008219        ,0.00,6200000,11262510257.29,19080200082190000086,
132,02/08/2019,13:08:51,02/08/2019,13:08:51,0247 UKT 1107617222 0819/0011806        ,0.00,3000000,11265510257.29,19080200118060000125,
133,02/08/2019,13:10:17,02/08/2019,13:10:17,0247 UKT 1102617093 0819/0008219        ,0.00,3000000,11268510257.29,19080200082190000088,
134,02/08/2019,13:10:37,02/08/2019,13:10:37,0247 UKT 1801618069 0819/0013051        ,0.00,1000000,11269510257.29,19080200130510000126,
135,02/08/2019,13:16:12,02/08/2019,13:16:12,0247 UKT 1105618017 0819/0013080        ,0.00,1000000,11270510257.29,19080200130800000097,
136,02/08/2019,13:16:16,02/08/2019,13:16:16,0247 UKT 1206617048 0819/0016527        ,0.00,1000000,11271510257.29,19080200165270000065,
137,02/08/2019,13:19:54,02/08/2019,13:19:54,0247 UKT 1202617013 0819/0010946        ,0.00,5900000,11277410257.29,19080200109460000072,
138,02/08/2019,13:20:46,02/08/2019,13:20:46,0247 UKT 1107617203 0819/0017756        ,0.00,3000000,11280410257.29,19080200177560000077,
139,02/08/2019,13:23:55,02/08/2019,13:23:55,0247 UKT 1801617197 0819/0017978        ,0.00,6200000,11286610257.29,19080200179780000119,
140,02/08/2019,13:28:36,02/08/2019,13:28:36,0247 UKT 1801617095 0819/0017968        ,0.00,6200000,11292810257.29,19080200179680000069,
141,02/08/2019,13:30:27,02/08/2019,13:30:27,0247 UKT 1801617208 0819/0013065        ,0.00,4000000,11296810257.29,19080200130650000046,
142,02/08/2019,13:30:28,02/08/2019,13:30:28,0247 UKT 1801617174 0819/0005992        ,0.00,4000000,11300810257.29,19080200059920000022,
143,02/08/2019,13:42:50,02/08/2019,13:42:50,0247 UKT 1103617110 0819/0018015        ,0.00,3000000,11303810257.29,19080200180150000061,
144,02/08/2019,13:43:44,02/08/2019,13:43:44,0247 UKT 1205617008 0819/0007897        ,0.00,4500000,11308310257.29,19080200078970000075,
145,02/08/2019,13:46:48,02/08/2019,13:46:48,0247 UKT 1801618131 0819/0009558        ,0.00,4000000,11312310257.29,19080200095580000084,
146,02/08/2019,13:56:14,02/08/2019,13:56:14,0247 UKT 1801617190 0819/0016655        ,0.00,4000000,11316310257.29,19080200166550000135,
147,02/08/2019,13:59:23,02/08/2019,13:59:23,0247 UKT 1801617148 0819/0011914        ,0.00,8200000,11324510257.29,19080200119140000065,
148,02/08/2019,14:01:50,02/08/2019,14:01:50,0247 UKT 1801617273 0819/0012491        ,0.00,1000000,11325510257.29,19080200124910000163,
149,02/08/2019,14:06:02,02/08/2019,14:06:02,0247 UKT 1801617233 0819/0012478        ,0.00,1000000,11326510257.29,19080200124780000137,
150,02/08/2019,14:10:46,02/08/2019,14:10:46,0247 UKT 1208618025 0819/0008586        ,0.00,7400000,11333910257.29,19080200085860000070,
151,02/08/2019,14:16:25,02/08/2019,14:16:25,0247 UKT 1301618002 0819/0018015        ,0.00,500000,11334410257.29,19080200180150000065,
152,02/08/2019,14:16:56,02/08/2019,14:16:56,0247 UKT 1801617068 0819/0012240        ,0.00,8200000,11342610257.29,19080200122400000065,
153,02/08/2019,14:18:03,02/08/2019,14:18:03,0247 UKT                                ,0.00,6000000,11348610257.29,19080299113810052490,
154,02/08/2019,14:18:22,02/08/2019,14:18:22,0247 UKT 1307618017 0819/0012486        ,0.00,4150000,11352760257.29,19080200124860000061,
155,02/08/2019,14:19:36,02/08/2019,14:19:36,0247 UKT 1801617275 0819/0011549        ,0.00,8200000,11360960257.29,19080200115490000067,
156,02/08/2019,14:28:57,02/08/2019,14:28:57,0247 UKT                                ,0.00,6400000,11367360257.29,19080299143020142070,
157,02/08/2019,14:36:29,02/08/2019,14:36:29,0247 UKT 1308618058 0819/0016663        ,0.00,4150000,11371510257.29,19080200166630000028,
158,02/08/2019,14:38:54,02/08/2019,14:38:54,0247 UKT 1304617027 0819/0017772        ,0.00,3950000,11375460257.29,19080200177720000075,
159,02/08/2019,14:51:09,02/08/2019,14:51:09,0247 UKT 1801617037 0819/0009602        ,0.00,9300000,11384760257.29,19080200096020000073,
160,02/08/2019,14:53:05,02/08/2019,14:53:05,0247 UKT 1801618145 0819/0007348        ,0.00,8200000,11392960257.29,19080200073480000062,
161,02/08/2019,14:54:28,02/08/2019,14:54:28,0247 UKT 1801617199 0819/0013048        ,0.00,8200000,11401160257.29,19080200130480000207,
162,02/08/2019,15:10:23,02/08/2019,15:10:23,0247 UKT 1101617063 0819/0016491        ,0.00,4000000,11405160257.29,19080200164910000256,
163,02/08/2019,15:55:18,02/08/2019,15:55:18,0247 UKT 1801617243 0819/0017986        ,0.00,10300000,11415460257.29,19080200179860000076,
164,03/08/2019,11:01:12,03/08/2019,11:01:12,0247 UKT                                ,0.00,8000000,11423460257.29,19080399016820645517,
165,03/08/2019,11:15:44,03/08/2019,11:15:44,0247 UKT                                ,0.00,3900000,11427360257.29,19080399106110753595,
166,03/08/2019,18:43:01,03/08/2019,18:43:01,0247 UKT                                ,0.00,5900000,11433260257.29,19080399133070732836,
167,03/08/2019,20:49:50,03/08/2019,20:49:50,0247 UKT                                ,0.00,4000000,11437260257.29,19080399100410609250,
168,04/08/2019,09:58:11,04/08/2019,09:58:11,0247 UKT                                ,0.00,6200000,11443460257.29,19080499357010727817,
169,04/08/2019,11:04:44,04/08/2019,11:04:44,0247 UKT                                ,0.00,3900000,11447360257.29,19080499367010152874,
170,04/08/2019,17:35:55,04/08/2019,17:35:55,0247 UKT                                ,0.00,10300000,11457660257.29,19080499379090339849,
171,05/08/2019,15:26:55,05/08/2019,15:26:55,1138/RTGS/BNI/204852841/RPL 088 UNJ UNTU,5000000000,0.00,6457660257.29,19080500082190000038,
172,06/08/2019,11:18:49,06/08/2019,11:18:49,0247 UKT 1303617072 0819/0018179        ,0.00,5200000,6462860257.29,19080600181790000136,
173,06/08/2019,11:20:21,06/08/2019,11:20:21,0247 UKT 1301617047 0819/0016484        ,0.00,3800000,6466660257.29,19080600164840000225,
174,06/08/2019,11:23:28,06/08/2019,11:23:28,0247 UKT 1801617220 0819/0013066        ,0.00,4000000,6470660257.29,19080600130660000037,
175,06/08/2019,11:28:27,06/08/2019,11:28:27,0247 UKT 1107618107 0819/0008219        ,0.00,3000000,6473660257.29,19080600082190000072,
176,06/08/2019,11:29:00,06/08/2019,11:29:00,0247 UKT 1107617043 0819/0007901        ,0.00,3000000,6476660257.29,19080600079010000089,
177,06/08/2019,11:29:56,06/08/2019,11:29:56,0247 UKT 1303618005 0819/0008219        ,0.00,6200000,6482860257.29,19080600082190000074,
178,06/08/2019,11:30:37,06/08/2019,11:30:37,0247 UKT 1107617033 0819/0016715        ,0.00,5100000,6487960257.29,19080600167150000061,
179,06/08/2019,11:38:05,06/08/2019,11:38:05,0247 UKT 1102617020 0819/0016616        ,0.00,5100000,6493060257.29,19080600166160000051,
180,06/08/2019,11:38:14,06/08/2019,11:38:14,0247 UKT 1206617003 0819/0012245        ,0.00,4500000,6497560257.29,19080600122450000142,
181,06/08/2019,11:38:28,06/08/2019,11:38:28,0247 UKT 1101618071 0819/0013714        ,0.00,1000000,6498560257.29,19080600137140000128,
182,06/08/2019,11:40:18,06/08/2019,11:40:18,0247 UKT 1801618138 0819/0013678        ,0.00,4000000,6502560257.29,19080600136780000165,
183,06/08/2019,11:43:10,06/08/2019,11:43:10,0247 UKT 1313617030 0819/0011952        ,0.00,500000,6503060257.29,19080600119520000230,
184,06/08/2019,11:44:16,06/08/2019,11:44:16,0247 UKT 1801617056 0819/0007222        ,0.00,8200000,6511260257.29,19080600072220000090,
185,06/08/2019,11:53:09,06/08/2019,11:53:09,0247 UKT 1107617069 0819/0013762        ,0.00,6400000,6517660257.29,19080600137620000118,
186,06/08/2019,11:55:38,06/08/2019,11:55:38,0247 UKT 1207617003 0819/0011831        ,0.00,5900000,6523560257.29,19080600118310000044,
187,06/08/2019,11:55:44,06/08/2019,11:55:44,0247 UKT 1209618028 0819/0008586        ,0.00,6700000,6530260257.29,19080600085860000061,
188,06/08/2019,11:57:29,06/08/2019,11:57:29,0247 UKT 1308617042 0819/0016587        ,0.00,6250000,6536510257.29,19080600165870000070,
189,06/08/2019,12:05:08,06/08/2019,12:05:08,0247 UKT 1801617104 0819/0017017        ,0.00,6200000,6542710257.29,19080600170170000071,
190,06/08/2019,12:16:11,06/08/2019,12:16:11,0247 UKT 1107617036 0819/0016715        ,0.00,5800000,6548510257.29,19080600167150000069,
191,06/08/2019,12:18:36,06/08/2019,12:18:36,0247 UKT 1801618070 0819/0016655        ,0.00,6200000,6554710257.29,19080600166550000192,
192,06/08/2019,12:26:41,06/08/2019,12:26:41,0247 UKT 1603617053 0819/0018024        ,0.00,3200000,6557910257.29,19080600180240000056,
193,06/08/2019,12:30:10,06/08/2019,12:30:10,0247 UKT 1106617012 0819/0007337        ,0.00,3000000,6560910257.29,19080600073370000115,
194,06/08/2019,12:37:52,06/08/2019,12:37:52,0247 UKT 1211617048 0819/0012927        ,0.00,5000000,6565910257.29,19080600129270000041,
195,06/08/2019,12:41:16,06/08/2019,12:41:16,0247 UKT 1304617050 0819/0012937        ,0.00,6200000,6572110257.29,19080600129370000053,
196,06/08/2019,13:09:05,06/08/2019,13:09:05,0247 UKT 1207617027 0819/0008264        ,0.00,4500000,6576610257.29,19080600082640000076,
197,06/08/2019,13:09:09,06/08/2019,13:09:09,0247 UKT 1801617074 0819/0008219        ,0.00,9300000,6585910257.29,19080600082190000080,
198,06/08/2019,13:11:39,06/08/2019,13:11:39,0247 UKT 1206618057 0819/0010761        ,0.00,6700000,6592610257.29,19080600107610000247,
199,06/08/2019,13:11:52,06/08/2019,13:11:52,0247 UKT 1207617025 0819/0008294        ,0.00,1000000,6593610257.29,19080600082940000190,
200,06/08/2019,13:17:10,06/08/2019,13:17:10,0247 UKT 1601618050 0819/0013065        ,0.00,4700000,6598310257.29,19080600130650000082,
201,06/08/2019,13:18:40,06/08/2019,13:18:40,0247 UKT 1204618037 0819/0010462        ,0.00,6100000,6604410257.29,19080600104620000101,
202,06/08/2019,13:19:08,06/08/2019,13:19:08,0247 UKT 1103618031 0819/0012475        ,0.00,3000000,6607410257.29,19080600124750000034,
203,06/08/2019,13:25:10,06/08/2019,13:25:10,0247 UKT 1107617117 0819/0008551        ,0.00,5100000,6612510257.29,19080600085510000137,
204,06/08/2019,13:25:45,06/08/2019,13:25:45,0247 UKT 1301617009 0819/0005990        ,0.00,1000000,6613510257.29,19080600059900000103,
205,06/08/2019,13:26:33,06/08/2019,13:26:33,0247 UKT 1201617058 0819/0013080        ,0.00,4000000,6617510257.29,19080600130800000098,
206,06/08/2019,13:29:33,06/08/2019,13:29:33,0247 UKT 1801617066 0819/0006827        ,0.00,6200000,6623710257.29,19080600068270000089,
207,06/08/2019,13:35:41,06/08/2019,13:35:41,0247 UKT 1303618050 0819/0007759        ,0.00,6200000,6629910257.29,19080600077590000135,
208,06/08/2019,13:36:54,06/08/2019,13:36:54,0247 UKT 1801617175 0819/2816439        ,0.00,6200000,6636110257.29,19080628164390000047,
209,06/08/2019,13:37:31,06/08/2019,13:37:31,0247 UKT 1314617033 0819/0016657        ,0.00,4000000,6640110257.29,19080600166570000132,
210,06/08/2019,13:39:09,06/08/2019,13:39:09,0247 UKT 1107617147 0819/0006664        ,0.00,500000,6640610257.29,19080600066640000103,
211,06/08/2019,13:40:03,06/08/2019,13:40:03,0247 UKT 1603618003 0819/0008219        ,0.00,5400000,6646010257.29,19080600082190000086,
212,06/08/2019,13:42:19,06/08/2019,13:42:19,0247 UKT 1602618030 0819/0008219        ,0.00,1000000,6647010257.29,19080600082190000088,
213,06/08/2019,13:44:42,06/08/2019,13:44:42,0247 UKT 1308617058 0819/0008236        ,0.00,6250000,6653260257.29,19080600082360000250,
214,06/08/2019,13:47:57,06/08/2019,13:47:57,0247 UKT 1302617008 0819/0013447        ,0.00,3800000,6657060257.29,19080600134470000170,
215,06/08/2019,13:48:07,06/08/2019,13:48:07,0247 UKT 1207617020 0819/0017017        ,0.00,1000000,6658060257.29,19080600170170000102,
216,06/08/2019,13:55:21,06/08/2019,13:55:21,0247 UKT 1302618037 0819/0013485        ,0.00,3800000,6661860257.29,19080600134850000059,
217,06/08/2019,13:56:00,06/08/2019,13:56:00,0247 UKT 1801618066 0819/0016491        ,0.00,4000000,6665860257.29,19080600164910000291,
218,06/08/2019,14:00:31,06/08/2019,14:00:31,0247 UKT 1211618030 0819/0017787        ,0.00,5600000,6671460257.29,19080600177870000252,
219,06/08/2019,14:03:22,06/08/2019,14:03:22,0247 UKT 1801617221 0819/0013811        ,0.00,6200000,6677660257.29,19080600138110000090,
220,06/08/2019,14:07:01,06/08/2019,14:07:01,0247 UKT 1107617245 0819/0011952        ,0.00,5100000,6682760257.29,19080600119520000322,
221,06/08/2019,14:07:09,06/08/2019,14:07:09,0247 UKT 1801617078 0819/0010941        ,0.00,9300000,6692060257.29,19080600109410000150,
222,06/08/2019,14:08:11,06/08/2019,14:08:11,0247 UKT 1203618046 0819/0008219        ,0.00,12400000,6704460257.29,19080600082190000090,
223,06/08/2019,14:14:54,06/08/2019,14:14:54,0247 UKT 1801617128 0819/0010462        ,0.00,7200000,6711660257.29,19080600104620000108,
224,06/08/2019,14:16:19,06/08/2019,14:16:19,0247 UKT 1103618060 0819/0011838        ,0.00,5300000,6716960257.29,19080600118380000019,
225,06/08/2019,14:21:09,06/08/2019,14:21:09,0247 UKT 1303618015 0819/0017966        ,0.00,4500000,6721460257.29,19080600179660000100,
226,06/08/2019,14:35:45,06/08/2019,14:35:45,0247 UKT 1313617018 0819/0008219        ,0.00,4000000,6725460257.29,19080600082190000094,
227,06/08/2019,14:38:30,06/08/2019,14:38:30,0247 UKT 1801617311 0819/0008219        ,0.00,8200000,6733660257.29,19080600082190000096,
228,06/08/2019,14:40:30,06/08/2019,14:40:30,0247 UKT 1602617092 0819/0009659        ,0.00,1000000,6734660257.29,19080600096590000132,
229,06/08/2019,14:43:59,06/08/2019,14:43:59,0247 UKT 1304617013 0819/0012938        ,0.00,7500000,6742160257.29,19080600129380000023,
230,06/08/2019,14:46:03,06/08/2019,14:46:03,0247 UKT 1304617007 0819/0018021        ,0.00,6200000,6748360257.29,19080600180210000362,
231,06/08/2019,14:46:28,06/08/2019,14:46:28,0247 UKT 1801617264 0819/0017995        ,0.00,4000000,6752360257.29,19080600179950000113,
232,06/08/2019,14:46:46,06/08/2019,14:46:46,0247 UKT 1104617073 0819/0008219        ,0.00,3000000,6755360257.29,19080600082190000098,
233,06/08/2019,15:01:24,06/08/2019,15:01:24,0247 UKT 1205617087 0819/0008219        ,0.00,3900000,6759260257.29,19080600082190000104,
234,06/08/2019,15:01:37,06/08/2019,15:01:37,0247 UKT 1203618039 0819/0017783        ,0.00,3700000,6762960257.29,19080600177830000178,
235,06/08/2019,15:04:11,06/08/2019,15:04:11,0247 UKT 1313618036 0819/0010413        ,0.00,6200000,6769160257.29,19080600104130000185,
236,06/08/2019,15:15:51,06/08/2019,15:15:51,0247 UKT 1209617067 0819/0011932        ,0.00,7400000,6776560257.29,19080600119320000068,
237,06/08/2019,19:40:02,06/08/2019,19:40:02,0247 UKT                                ,0.00,4500000,6781060257.29,19080699167010739956,
238,06/08/2019,22:35:08,06/08/2019,22:35:08,0247 UKT                                ,0.00,3700000,6784760257.29,19080699211270891189,
239,07/08/2019,08:04:07,07/08/2019,08:04:07,0247 UKT 1313617033 0819/0006827        ,0.00,1000000,6785760257.29,19080700068270000002,
240,07/08/2019,08:19:04,07/08/2019,08:19:04,0247 UKT 1211617013 0819/0008219        ,0.00,3700000,6789460257.29,19080700082190000004,
241,07/08/2019,08:20:16,07/08/2019,08:20:16,0247 UKT 1211617005 0819/0008219        ,0.00,3700000,6793160257.29,19080700082190000006,
242,07/08/2019,08:40:36,07/08/2019,08:40:36,0247 UKT 1103617051 0819/0016534        ,0.00,6000000,6799160257.29,19080700165340000006,
243,07/08/2019,08:43:59,07/08/2019,08:43:59,0247 UKT 1202617018 0819/0012937        ,0.00,6400000,6805560257.29,19080700129370000006,
244,07/08/2019,08:44:49,07/08/2019,08:44:49,0247 UKT 1308617003 0819/0008219        ,0.00,4150000,6809710257.29,19080700082190000053,
245,07/08/2019,08:46:28,07/08/2019,08:46:28,0247 UKT 1308617005 0819/0008219        ,0.00,6250000,6815960257.29,19080700082190000055,
246,07/08/2019,08:47:21,07/08/2019,08:47:21,0247 UKT 1304618038 0819/0012245        ,0.00,3950000,6819910257.29,19080700122450000030,
247,07/08/2019,08:49:34,07/08/2019,08:49:34,0247 UKT 1103617023 0819/0007248        ,0.00,3000000,6822910257.29,19080700072480000016,
248,07/08/2019,08:51:44,07/08/2019,08:51:44,0247 UKT 1801618059 0819/0008555        ,0.00,4000000,6826910257.29,19080700085550000010,
249,07/08/2019,09:00:07,07/08/2019,09:00:07,0247 UKT 1202618014 0819/0006459        ,0.00,6400000,6833310257.29,19080700064590000031,
250,07/08/2019,09:00:14,07/08/2019,09:00:14,0247 UKT 1202617042 0819/0012245        ,0.00,3900000,6837210257.29,19080700122450000036,
251,07/08/2019,09:17:29,07/08/2019,09:17:29,0247 UKT 1801617216 0819/0007887        ,0.00,10300000,6847510257.29,19080700078870000069,
252,07/08/2019,09:17:55,07/08/2019,09:17:55,0247 UKT 1304618005 0819/0008219        ,0.00,500000,6848010257.29,19080700082190000057,
253,07/08/2019,09:20:23,07/08/2019,09:20:23,0247 UKT 1105618057 0819/0011952        ,0.00,5100000,6853110257.29,19080700119520000054,
254,07/08/2019,09:21:41,07/08/2019,09:21:41,0247 UKT 1103617105 0819/0017768        ,0.00,1000000,6854110257.29,19080700177680000025,
255,07/08/2019,09:25:24,07/08/2019,09:25:24,0247 UKT 1301618022 0819/0013784        ,0.00,7000000,6861110257.29,19080700137840000018,
256,07/08/2019,09:27:05,07/08/2019,09:27:05,0247 UKT 1302617057 0819/0007887        ,0.00,3800000,6864910257.29,19080700078870000080,
257,07/08/2019,09:28:05,07/08/2019,09:28:05,0247 UKT 1204617028 0819/0008219        ,0.00,5900000,6870810257.29,19080700082190000063,
258,07/08/2019,09:28:05,07/08/2019,09:28:05,0247 UKT 1801618017 0819/0010403        ,0.00,8200000,6879010257.29,19080700104030000060,
259,07/08/2019,09:29:13,07/08/2019,09:29:13,0247 UKT 1107618020 0819/0009627        ,0.00,5800000,6884810257.29,19080700096270000004,
260,07/08/2019,09:30:43,07/08/2019,09:30:43,0247 UKT 1308618043 0819/0008219        ,0.00,6250000,6891060257.29,19080700082190000065,
261,07/08/2019,09:33:20,07/08/2019,09:33:20,0247 UKT 1207618053 0819/0013678        ,0.00,7400000,6898460257.29,19080700136780000054,
262,07/08/2019,09:36:17,07/08/2019,09:36:17,0247 UKT 1302618056 0819/0013467        ,0.00,3800000,6902260257.29,19080700134670000045,
263,07/08/2019,09:36:34,07/08/2019,09:36:34,0247 UKT 1306617002 0819/0016727        ,0.00,4000000,6906260257.29,19080700167270000070,
264,07/08/2019,09:38:46,07/08/2019,09:38:46,0247 UKT 1801618085 0819/0008219        ,0.00,10300000,6916560257.29,19080700082190000069,
265,07/08/2019,09:39:16,07/08/2019,09:39:16,0247 UKT 1801618105 0819/0018022        ,0.00,6200000,6922760257.29,19080700180220000045,
266,07/08/2019,09:41:54,07/08/2019,09:41:54,0247 UKT 1208617043 0819/0007348        ,0.00,5200000,6927960257.29,19080700073480000051,
267,07/08/2019,09:43:31,07/08/2019,09:43:31,0247 UKT 1205617095 0819/0007348        ,0.00,5200000,6933160257.29,19080700073480000053,
268,07/08/2019,09:45:19,07/08/2019,09:45:19,0247 UKT 1302618007 0819/0016518        ,0.00,5000000,6938160257.29,19080700165180000023,
269,07/08/2019,09:45:52,07/08/2019,09:45:52,0247 UKT 1601617109 0819/0011829        ,0.00,5700000,6943860257.29,19080700118290000049,
270,07/08/2019,09:46:49,07/08/2019,09:46:49,0247 UKT 1308618056 0819/0008220        ,0.00,6250000,6950110257.29,19080700082200000007,
271,07/08/2019,09:48:44,07/08/2019,09:48:44,0247 UKT 1208617040 0819/0008219        ,0.00,4500000,6954610257.29,19080700082190000073,
272,07/08/2019,09:54:38,07/08/2019,09:54:38,0247 UKT 1305617005 0819/0012490        ,0.00,6200000,6960810257.29,19080700124900000047,
273,07/08/2019,09:55:35,07/08/2019,09:55:35,0247 UKT 1202617002 0819/0013175        ,0.00,3900000,6964710257.29,19080700131750000141,
274,07/08/2019,10:08:53,07/08/2019,10:08:53,0247 UKT 1801618140 0819/0008219        ,0.00,4000000,6968710257.29,19080700082190000075,
275,07/08/2019,10:11:41,07/08/2019,10:11:41,0247 UKT 1307618014 0819/0005990        ,0.00,5250000,6973960257.29,19080700059900000039,
276,07/08/2019,11:11:07,07/08/2019,11:11:07,0247 UKT 1801617025 0819/0013446        ,0.00,4000000,6977960257.29,19080700134460000052,
277,07/08/2019,11:12:27,07/08/2019,11:12:27,0247 UKT 1304617061 0819/0012245        ,0.00,6200000,6984160257.29,19080700122450000080,
278,07/08/2019,11:18:27,07/08/2019,11:18:27,0247 UKT 1304618007 0819/0008554        ,0.00,5200000,6989360257.29,19080700085540000113,
279,07/08/2019,11:18:58,07/08/2019,11:18:58,0247 UKT                                ,0.00,4650000,6994010257.29,19080799113810672577,
280,07/08/2019,11:20:12,07/08/2019,11:20:12,0247 UKT 1208617055 0819/0008219        ,0.00,7400000,7001410257.29,19080700082190000122,
281,07/08/2019,11:21:04,07/08/2019,11:21:04,0247 UKT 1801617179 0819/0012479        ,0.00,10300000,7011710257.29,19080700124790000029,
282,07/08/2019,11:23:09,07/08/2019,11:23:09,0247 UKT 1801618029 0819/0008219        ,0.00,6200000,7017910257.29,19080700082190000124,
283,07/08/2019,11:24:41,07/08/2019,11:24:41,0247 UKT 1202617051 0819/0008219        ,0.00,3900000,7021810257.29,19080700082190000126,
284,07/08/2019,11:24:49,07/08/2019,11:24:49,0247 UKT 1605618016 0819/0013825        ,0.00,3200000,7025010257.29,19080700138250000259,
285,07/08/2019,11:25:26,07/08/2019,11:25:26,0247 UKT 1105617053 0819/0012249        ,0.00,4500000,7029510257.29,19080700122490000078,
286,07/08/2019,11:25:54,07/08/2019,11:25:54,0247 UKT 1801617299 0819/0008219        ,0.00,7200000,7036710257.29,19080700082190000128,
287,07/08/2019,11:42:20,07/08/2019,11:42:20,0247 UKT 1304617030 0819/0008219        ,0.00,5200000,7041910257.29,19080700082190000136,
288,07/08/2019,11:46:59,07/08/2019,11:46:59,0247 UKT 1801617210 0819/0008586        ,0.00,6200000,7048110257.29,19080700085860000058,
289,07/08/2019,11:47:01,07/08/2019,11:47:01,0247 UKT 1203617029 0819/0008219        ,0.00,5600000,7053710257.29,19080700082190000138,
290,07/08/2019,12:02:17,07/08/2019,12:02:17,0247 UKT 1801618142 0819/0012490        ,0.00,8200000,7061910257.29,19080700124900000083,
291,07/08/2019,12:02:23,07/08/2019,12:02:23,0247 UKT 1202617029 0819/0018024        ,0.00,5900000,7067810257.29,19080700180240000048,
292,07/08/2019,12:06:44,07/08/2019,12:06:44,0247 UKT 1208617061 0819/0016549        ,0.00,6700000,7074510257.29,19080700165490000080,
293,07/08/2019,12:10:20,07/08/2019,12:10:20,0247 UKT 1211617021 0819/0010462        ,0.00,5600000,7080110257.29,19080700104620000059,
294,07/08/2019,12:16:26,07/08/2019,12:16:26,0247 UKT 1801617132 0819/0016488        ,0.00,6200000,7086310257.29,19080700164880000053,
295,07/08/2019,12:35:19,07/08/2019,12:35:19,0247 UKT 1308617035 0819/0012927        ,0.00,6250000,7092560257.29,19080700129270000032,
296,07/08/2019,12:35:43,07/08/2019,12:35:43,0247 UKT 1206617022 0819/0016629        ,0.00,4500000,7097060257.29,19080700166290000007,
297,07/08/2019,12:40:18,07/08/2019,12:40:18,0247 UKT 1106618052 0819/0008179        ,0.00,3900000,7100960257.29,19080700081790000067,
298,07/08/2019,12:51:11,07/08/2019,12:51:11,0247 UKT 1801617237 0819/0008957        ,0.00,4000000,7104960257.29,19080700089570000056,
299,07/08/2019,12:54:55,07/08/2019,12:54:55,0247 UKT 1308617044 0819/0017755        ,0.00,6250000,7111210257.29,19080700177550000071,
300,07/08/2019,12:59:36,07/08/2019,12:59:36,0247 UKT 1207617009 0819/0008207        ,0.00,4500000,7115710257.29,19080700082070000215,
301,07/08/2019,13:02:45,07/08/2019,13:02:45,0247 UKT 1211618043 0819/0008219        ,0.00,6200000,7121910257.29,19080700082190000142,
302,07/08/2019,13:03:53,07/08/2019,13:03:53,0247 UKT 1602617067 0819/0008219        ,0.00,2700000,7124610257.29,19080700082190000144,
303,07/08/2019,13:06:04,07/08/2019,13:06:04,0247 UKT 1207617033 0819/0008219        ,0.00,7400000,7132010257.29,19080700082190000146,
304,07/08/2019,13:09:07,07/08/2019,13:09:07,0247 UKT 1107617154 0819/0008219        ,0.00,3000000,7135010257.29,19080700082190000148,
305,07/08/2019,13:09:25,07/08/2019,13:09:25,0247 UKT 1602617100 0819/0008574        ,0.00,3400000,7138410257.29,19080700085740000163,
306,07/08/2019,13:10:22,07/08/2019,13:10:22,0247 UKT 1602617179 0819/0008594        ,0.00,4700000,7143110257.29,19080700085940000028,
307,07/08/2019,13:15:19,07/08/2019,13:15:19,0247 UKT 1601617034 0819/0007348        ,0.00,3400000,7146510257.29,19080700073480000175,
308,07/08/2019,13:18:53,07/08/2019,13:18:53,0247 UKT 1104618054 0819/0008219        ,0.00,3000000,7149510257.29,19080700082190000150,
309,07/08/2019,13:20:51,07/08/2019,13:20:51,0247 UKT 1304617048 0819/0008219        ,0.00,9000000,7158510257.29,19080700082190000152,
310,07/08/2019,13:22:13,07/08/2019,13:22:13,0247 UKT 1208617010 0819/0008219        ,0.00,1000000,7159510257.29,19080700082190000154,
311,07/08/2019,13:30:49,07/08/2019,13:30:49,0247 UKT 1308618016 0819/0008219        ,0.00,8000000,7167510257.29,19080700082190000158,
312,07/08/2019,13:31:53,07/08/2019,13:31:53,0247 UKT 1801617213 0819/0018024        ,0.00,9300000,7176810257.29,19080700180240000054,
313,07/08/2019,13:31:58,07/08/2019,13:31:58,0247 UKT 1202617034 0819/0010963        ,0.00,5900000,7182710257.29,19080700109630000079,
314,07/08/2019,13:32:21,07/08/2019,13:32:21,0247 UKT 1301617004 0819/0016696        ,0.00,6000000,7188710257.29,19080700166960000031,
315,07/08/2019,13:32:31,07/08/2019,13:32:31,0247 UKT                                ,0.00,6200000,7194910257.29,19080799125010728351,
316,07/08/2019,13:37:33,07/08/2019,13:37:33,0247 UKT 1107618089 0819/0017756        ,0.00,5100000,7200010257.29,19080700177560000125,
317,07/08/2019,13:38:52,07/08/2019,13:38:52,0247 UKT 1801617045 0819/0018024        ,0.00,10300000,7210310257.29,19080700180240000056,
318,07/08/2019,13:41:11,07/08/2019,13:41:11,0247 UKT 1107617020 0819/0005990        ,0.00,3000000,7213310257.29,19080700059900000067,
319,07/08/2019,13:42:52,07/08/2019,13:42:52,0247 UKT 1801617016 0819/0016631        ,0.00,8200000,7221510257.29,19080700166310000036,
320,07/08/2019,13:43:04,07/08/2019,13:43:04,0247 UKT 1308618048 0819/0008219        ,0.00,8000000,7229510257.29,19080700082190000163,
321,07/08/2019,13:43:49,07/08/2019,13:43:49,0247 UKT 1102617029 0819/0010972        ,0.00,5100000,7234610257.29,19080700109720000114,
322,07/08/2019,13:46:57,07/08/2019,13:46:57,0247 UKT 1308618004 0819/0008219        ,0.00,4150000,7238760257.29,19080700082190000165,
323,07/08/2019,13:47:39,07/08/2019,13:47:39,0247 UKT 1105617074 0819/0008586        ,0.00,3900000,7242660257.29,19080700085860000071,
324,07/08/2019,13:49:36,07/08/2019,13:49:36,0247 UKT 1801617048 0819/0008219        ,0.00,7200000,7249860257.29,19080700082190000167,
325,07/08/2019,13:51:08,07/08/2019,13:51:08,0247 UKT 1107618136 0819/0008219        ,0.00,5100000,7254960257.29,19080700082190000169,
326,07/08/2019,14:01:10,07/08/2019,14:01:10,0247 UKT 1103618082 0819/0008558        ,0.00,1000000,7255960257.29,19080700085580000029,
327,07/08/2019,14:03:10,07/08/2019,14:03:10,0247 UKT 1104617023 0819/0013505        ,0.00,5300000,7261260257.29,19080700135050000299,
328,07/08/2019,14:06:18,07/08/2019,14:06:18,0247 UKT 1206618018 0819/0013051        ,0.00,4500000,7265760257.29,19080700130510000108,
329,07/08/2019,14:09:17,07/08/2019,14:09:17,0247 UKT 1210618027 0819/0008219        ,0.00,1000000,7266760257.29,19080700082190000173,
330,07/08/2019,14:10:13,07/08/2019,14:10:13,0247 UKT 1308618059 0819/0013482        ,0.00,6250000,7273010257.29,19080700134820000125,
331,07/08/2019,14:11:10,07/08/2019,14:11:10,0247 UKT 1801618116 0819/0008561        ,0.00,8200000,7281210257.29,19080700085610000078,
332,07/08/2019,14:13:57,07/08/2019,14:13:57,0247 UKT 1208618034 0819/0010493        ,0.00,500000,7281710257.29,19080700104930000049,
333,07/08/2019,14:13:58,07/08/2019,14:13:58,0247 UKT 1301617017 0819/0008219        ,0.00,6000000,7287710257.29,19080700082190000178,
334,07/08/2019,14:14:59,07/08/2019,14:14:59,0247 UKT 1801618033 0819/0012479        ,0.00,4000000,7291710257.29,19080700124790000070,
335,07/08/2019,14:20:42,07/08/2019,14:20:42,0247 UKT 1801618137 0819/0017016        ,0.00,4000000,7295710257.29,19080700170160000329,
336,07/08/2019,14:21:29,07/08/2019,14:21:29,0247 UKT 1205618076 0819/0008219        ,0.00,5900000,7301610257.29,19080700082190000180,
337,07/08/2019,14:22:30,07/08/2019,14:22:30,0247 UKT 1801617146 0819/0009593        ,0.00,7200000,7308810257.29,19080700095930000006,
338,07/08/2019,14:25:58,07/08/2019,14:25:58,0247 UKT 1107617163 0819/0016688        ,0.00,3000000,7311810257.29,19080700166880000182,
339,07/08/2019,14:26:12,07/08/2019,14:26:12,0247 UKT 1205618080 0819/0008219        ,0.00,3900000,7315710257.29,19080700082190000182,
340,07/08/2019,14:32:08,07/08/2019,14:32:08,0247 UKT 1801617060 0819/0007901        ,0.00,7200000,7322910257.29,19080700079010000173,
341,07/08/2019,14:35:03,07/08/2019,14:35:03,0247 UKT 1105618035 0819/0008219        ,0.00,3900000,7326810257.29,19080700082190000184,
342,07/08/2019,14:36:29,07/08/2019,14:36:29,0247 UKT 1104618045 0819/0008219        ,0.00,3000000,7329810257.29,19080700082190000186,
343,07/08/2019,14:37:57,07/08/2019,14:37:57,0247 UKT 1205618093 0819/0008219        ,0.00,5200000,7335010257.29,19080700082190000188,
344,07/08/2019,14:40:47,07/08/2019,14:40:47,0247 UKT 1801617029 0819/0006827        ,0.00,8200000,7343210257.29,19080700068270000208,
345,07/08/2019,14:40:54,07/08/2019,14:40:54,0247 UKT 1206618042 0819/0006789        ,0.00,4500000,7347710257.29,19080700067890000072,
346,07/08/2019,14:44:17,07/08/2019,14:44:17,0247 UKT 1308618026 0819/0009754        ,0.00,6250000,7353960257.29,19080700097540000123,
347,07/08/2019,14:57:33,07/08/2019,14:57:33,0247 UKT 1303617057 0819/0008219        ,0.00,3950000,7357910257.29,19080700082190000190,
348,07/08/2019,15:00:01,07/08/2019,15:00:01,0247 UKT 1205618100 0819/0008219        ,0.00,3900000,7361810257.29,19080700082190000192,
349,07/08/2019,15:01:58,07/08/2019,15:01:58,0247 UKT 1208618018 0819/0013051        ,0.00,7400000,7369210257.29,19080700130510000135,
350,07/08/2019,15:12:27,07/08/2019,15:12:27,0247 UKT 1303617065 0819/0007168        ,0.00,6200000,7375410257.29,19080700071680000240,
351,07/08/2019,15:13:49,07/08/2019,15:13:49,0247 UKT 1306617023 0819/0008244        ,0.00,12400000,7387810257.29,19080700082440000077,
352,08/08/2019,08:12:09,08/08/2019,08:12:09,0247 UKT 1801618064 0819/0016989        ,0.00,6200000,7394010257.29,19080800169890000012,
353,08/08/2019,08:17:08,08/08/2019,08:17:08,0247 UKT 1801617162 0819/0013085        ,0.00,4000000,7398010257.29,19080800130850000004,
354,08/08/2019,08:57:10,08/08/2019,08:57:10,0247 UKT 1102617019 0819/0008247        ,0.00,1000000,7399010257.29,19080800082470000032,
355,08/08/2019,08:57:53,08/08/2019,08:57:53,0247 UKT 1313617005 0819/0008219        ,0.00,1000000,7400010257.29,19080800082190000006,
356,08/08/2019,09:00:19,08/08/2019,09:00:19,0247 UKT 1801617248 0819/0016436        ,0.00,8200000,7408210257.29,19080800164360000012,
357,08/08/2019,09:00:27,08/08/2019,09:00:27,0247 UKT 1801617103 0819/0008219        ,0.00,7200000,7415410257.29,19080800082190000008,
358,08/08/2019,09:00:44,08/08/2019,09:00:44,0247 UKT 1206618020 0819/0012233        ,0.00,6700000,7422110257.29,19080800122330000004,
359,08/08/2019,09:01:38,08/08/2019,09:01:38,0247 UKT 1201618030 0819/0009752        ,0.00,4000000,7426110257.29,19080800097520000012,
360,08/08/2019,09:02:08,08/08/2019,09:02:08,0247 UKT 1105618044 0819/0007248        ,0.00,3900000,7430010257.29,19080800072480000016,
361,08/08/2019,09:08:53,08/08/2019,09:08:53,0247 UKT 1801617133 0819/0008298        ,0.00,6200000,7436210257.29,19080800082980000004,
362,08/08/2019,09:11:47,08/08/2019,09:11:47,0247 UKT 1107617223 0819/0017001        ,0.00,1000000,7437210257.29,19080800170010000010,
363,08/08/2019,09:13:52,08/08/2019,09:13:52,0247 UKT 1301617054 0819/0013060        ,0.00,6000000,7443210257.29,19080800130600000011,
364,08/08/2019,09:15:59,08/08/2019,09:15:59,0247 UKT 1207617007 0819/0008219        ,0.00,5900000,7449110257.29,19080800082190000013,
365,08/08/2019,09:17:24,08/08/2019,09:17:24,0247 UKT 1602618066 0819/0013485        ,0.00,4700000,7453810257.29,19080800134850000002,
366,08/08/2019,09:20:49,08/08/2019,09:20:49,0247 UKT 1601617219 0819/0013087        ,0.00,2700000,7456510257.29,19080800130870000018,
367,08/08/2019,09:22:29,08/08/2019,09:22:29,0247 UKT 1301617059 0819/0010960        ,0.00,5000000,7461510257.29,19080800109600000026,
368,08/08/2019,09:25:40,08/08/2019,09:25:40,0247 UKT 1801617147 0819/0017988        ,0.00,8200000,7469710257.29,19080800179880000018,
369,08/08/2019,09:26:03,08/08/2019,09:26:03,0247 UKT 1211618031 0819/0008219        ,0.00,5600000,7475310257.29,19080800082190000015,
370,08/08/2019,09:28:46,08/08/2019,09:28:46,0247 UKT 1205617090 0819/0008219        ,0.00,5200000,7480510257.29,19080800082190000017,
371,08/08/2019,09:29:05,08/08/2019,09:29:05,0247 UKT 1601617091 0819/0013062        ,0.00,3400000,7483910257.29,19080800130620000035,
372,08/08/2019,09:33:05,08/08/2019,09:33:05,0247 UKT 1201617052 0819/0008219        ,0.00,4000000,7487910257.29,19080800082190000019,
373,08/08/2019,09:37:33,08/08/2019,09:37:33,0247 UKT 1602617039 0819/0007168        ,0.00,4700000,7492610257.29,19080800071680000068,
374,08/08/2019,09:40:28,08/08/2019,09:40:28,0247 UKT 1801617227 0819/0008219        ,0.00,4000000,7496610257.29,19080800082190000021,
375,08/08/2019,09:44:44,08/08/2019,09:44:44,0247 UKT 1304617049 0819/0017773        ,0.00,3950000,7500560257.29,19080800177730000084,
376,08/08/2019,09:46:29,08/08/2019,09:46:29,0247 UKT 1314618014 0819/0008219        ,0.00,8811000,7509371257.29,19080800082190000023,
377,08/08/2019,09:46:54,08/08/2019,09:46:54,0247 UKT 1801618143 0819/0013507        ,0.00,8200000,7517571257.29,19080800135070000039,
378,08/08/2019,09:47:41,08/08/2019,09:47:41,0247 UKT 1801617265 0819/0012486        ,0.00,6200000,7523771257.29,19080800124860000019,
379,08/08/2019,09:47:47,08/08/2019,09:47:47,0247 UKT 1302618006 0819/0008175        ,0.00,3800000,7527571257.29,19080800081750000014,
380,08/08/2019,09:49:47,08/08/2019,09:49:47,0247 UKT 1205617051 0819/0008219        ,0.00,6400000,7533971257.29,19080800082190000025,
381,08/08/2019,09:50:56,08/08/2019,09:50:56,0247 UKT 1205617044 0819/0008219        ,0.00,3900000,7537871257.29,19080800082190000027,
382,08/08/2019,09:55:15,08/08/2019,09:55:15,0247 UKT 1801617219 0819/0016716        ,0.00,4000000,7541871257.29,19080800167160000024,
383,08/08/2019,09:56:29,08/08/2019,09:56:29,0247 UKT 1801617158 0819/0016718        ,0.00,4000000,7545871257.29,19080800167180000023,
384,08/08/2019,09:56:30,08/08/2019,09:56:30,0247 UKT 1207617047 0819/0008574        ,0.00,4500000,7550371257.29,19080800085740000079,
385,08/08/2019,09:59:05,08/08/2019,09:59:05,0247 UKT 1801617252 0819/0007248        ,0.00,8200000,7558571257.29,19080800072480000030,
386,08/08/2019,09:59:07,08/08/2019,09:59:07,0247 UKT 1303617011 0819/0008219        ,0.00,5200000,7563771257.29,19080800082190000032,
387,08/08/2019,10:00:38,08/08/2019,10:00:38,0247 UKT 1303617076 0819/0008219        ,0.00,3950000,7567721257.29,19080800082190000034,
388,08/08/2019,10:02:46,08/08/2019,10:02:46,0247 UKT 1308618010 0819/0011952        ,0.00,4150000,7571871257.29,19080800119520000051,
389,08/08/2019,10:04:27,08/08/2019,10:04:27,0247 UKT 1801617163 0819/0016716        ,0.00,6200000,7578071257.29,19080800167160000030,
390,08/08/2019,10:08:44,08/08/2019,10:08:44,0247 UKT 1213618020 0819/0008220        ,0.00,3700000,7581771257.29,19080800082200000024,
391,08/08/2019,10:09:34,08/08/2019,10:09:34,0247 UKT 1306617005 0819/0012490        ,0.00,6200000,7587971257.29,19080800124900000014,
392,08/08/2019,10:15:38,08/08/2019,10:15:38,0247 UKT 1107617025 0819/0008244        ,0.00,3000000,7590971257.29,19080800082440000018,
393,08/08/2019,10:15:44,08/08/2019,10:15:44,0247 UKT 1304617003 0819/0012474        ,0.00,5200000,7596171257.29,19080800124740000103,
394,08/08/2019,10:18:43,08/08/2019,10:18:43,0247 UKT 1801617120 0819/0016699        ,0.00,9300000,7605471257.29,19080800166990000069,
395,08/08/2019,10:20:27,08/08/2019,10:20:27,0247 UKT 1106617017 0819/0018015        ,0.00,5100000,7610571257.29,19080800180150000125,
396,08/08/2019,10:20:28,08/08/2019,10:20:28,0247 UKT 1801617141 0819/0017974        ,0.00,4000000,7614571257.29,19080800179740000078,
397,08/08/2019,10:31:00,08/08/2019,10:31:00,0247 UKT 1209617010 0819/0013080        ,0.00,1000000,7615571257.29,19080800130800000046,
398,08/08/2019,10:31:46,08/08/2019,10:31:46,0247 UKT 1603618001 0819/0017756        ,0.00,3200000,7618771257.29,19080800177560000031,
399,08/08/2019,10:32:28,08/08/2019,10:32:28,0247 UKT 1304618054 0819/0008219        ,0.00,6200000,7624971257.29,19080800082190000036,
400,08/08/2019,10:33:27,08/08/2019,10:33:27,0247 UKT 1801618077 0819/0017770        ,0.00,4000000,7628971257.29,19080800177700000098,
401,08/08/2019,10:34:41,08/08/2019,10:34:41,0247 UKT 1304618056 0819/0008219        ,0.00,3950000,7632921257.29,19080800082190000039,
402,08/08/2019,10:35:02,08/08/2019,10:35:02,0247 UKT 1202618025 0819/0010443        ,0.00,5900000,7638821257.29,19080800104430000030,
403,08/08/2019,10:35:07,08/08/2019,10:35:07,0247 UKT 1308617006 0819/0010977        ,0.00,4150000,7642971257.29,19080800109770000016,
404,08/08/2019,10:35:47,08/08/2019,10:35:47,0247 UKT 1801617285 0819/0016526        ,0.00,8200000,7651171257.29,19080800165260000032,
405,08/08/2019,10:35:51,08/08/2019,10:35:51,0247 UKT 1801617039 0819/0008145        ,0.00,7200000,7658371257.29,19080800081450000097,
406,08/08/2019,10:36:01,08/08/2019,10:36:01,0247 UKT 1308617063 0819/0008219        ,0.00,1000000,7659371257.29,19080800082190000041,
407,08/08/2019,10:36:01,08/08/2019,10:36:01,0247 UKT 1304618004 0819/0016655        ,0.00,3950000,7663321257.29,19080800166550000047,
408,08/08/2019,10:37:33,08/08/2019,10:37:33,0247 UKT 1308617043 0819/0018020        ,0.00,4150000,7667471257.29,19080800180200000034,
409,08/08/2019,10:38:25,08/08/2019,10:38:25,0247 UKT 1103618008 0819/0012923        ,0.00,4000000,7671471257.29,19080800129230000068,
410,08/08/2019,10:38:50,08/08/2019,10:38:50,0247 UKT 1303617035 0819/0008219        ,0.00,1000000,7672471257.29,19080800082190000043,
411,08/08/2019,10:43:10,08/08/2019,10:43:10,0247 UKT 1201617044 0819/0008221        ,0.00,6000000,7678471257.29,19080800082210000132,
412,08/08/2019,10:45:30,08/08/2019,10:45:30,0247 UKT 1801618149 0819/0008219        ,0.00,6200000,7684671257.29,19080800082190000047,
413,08/08/2019,10:49:26,08/08/2019,10:49:26,0247 UKT 1304618026 0819/0008219        ,0.00,6200000,7690871257.29,19080800082190000049,
414,08/08/2019,10:51:43,08/08/2019,10:51:43,0247 UKT 1210617040 0819/0008219        ,0.00,500000,7691371257.29,19080800082190000051,
415,08/08/2019,10:52:36,08/08/2019,10:52:36,0247 UKT 1801618063 0819/0008219        ,0.00,500000,7691871257.29,19080800082190000053,
416,08/08/2019,10:52:37,08/08/2019,10:52:37,0247 UKT                                ,0.00,6000000,7697871257.29,19080899166010210655,
417,08/08/2019,10:53:14,08/08/2019,10:53:14,0247 UKT 1303617067 0819/0013051        ,0.00,6200000,7704071257.29,19080800130510000084,
418,08/08/2019,10:53:26,08/08/2019,10:53:26,0247 UKT 1107617218 0819/0008219        ,0.00,6400000,7710471257.29,19080800082190000055,
419,08/08/2019,10:57:41,08/08/2019,10:57:41,0247 UKT 1209618020 0819/0008219        ,0.00,4500000,7714971257.29,19080800082190000057,
420,08/08/2019,10:58:59,08/08/2019,10:58:59,0247 UKT 1106617015 0819/0008309        ,0.00,5100000,7720071257.29,19080800083090000069,
421,08/08/2019,10:59:26,08/08/2019,10:59:26,0247 UKT 1203617034 0819/0008219        ,0.00,3700000,7723771257.29,19080800082190000059,
422,08/08/2019,11:02:35,08/08/2019,11:02:35,0247 UKT 1106617040 0819/0008219        ,0.00,5800000,7729571257.29,19080800082190000061,
423,08/08/2019,11:04:12,08/08/2019,11:04:12,0247 UKT 1801617154 0819/0013048        ,0.00,7200000,7736771257.29,19080800130480000162,
424,08/08/2019,11:04:16,08/08/2019,11:04:16,0247 UKT 1801618135 0819/0008219        ,0.00,1000000,7737771257.29,19080800082190000063,
425,08/08/2019,11:06:40,08/08/2019,11:06:40,0247 UKT 1207617035 0819/0008219        ,0.00,4500000,7742271257.29,19080800082190000065,
426,08/08/2019,11:06:49,08/08/2019,11:06:49,0247 UKT                                ,0.00,4300000,7746571257.29,19080899313010326943,
427,08/08/2019,11:08:38,08/08/2019,11:08:38,0247 UKT 1601617184 0819/0006635        ,0.00,4700000,7751271257.29,19080800066350000054,
428,08/08/2019,11:09:05,08/08/2019,11:09:05,0247 UKT 1207617061 0819/0008219        ,0.00,5200000,7756471257.29,19080800082190000067,
429,08/08/2019,11:10:19,08/08/2019,11:10:19,0247 UKT 1302618049 0819/0013467        ,0.00,4300000,7760771257.29,19080800134670000056,
430,08/08/2019,11:11:08,08/08/2019,11:11:08,0247 UKT 1304617031 0819/0010469        ,0.00,3950000,7764721257.29,19080800104690000060,
431,08/08/2019,11:11:43,08/08/2019,11:11:43,0247 UKT 1207618042 0819/0013442        ,0.00,6700000,7771421257.29,19080800134420000062,
432,08/08/2019,11:12:18,08/08/2019,11:12:18,0247 UKT 1207618047 0819/0008299        ,0.00,6700000,7778121257.29,19080800082990000118,
433,08/08/2019,11:15:53,08/08/2019,11:15:53,0247 UKT                                ,0.00,6200000,7784321257.29,19080899179150400616,
434,08/08/2019,11:18:13,08/08/2019,11:18:13,0247 UKT 1801617019 0819/0016717        ,0.00,4000000,7788321257.29,19080800167170000009,
435,08/08/2019,11:18:47,08/08/2019,11:18:47,0247 UKT                                ,0.00,5200000,7793521257.29,19080899113810424952,
436,08/08/2019,11:22:51,08/08/2019,11:22:51,0247 UKT 1302617013 0819/0008219        ,0.00,5000000,7798521257.29,19080800082190000069,
437,08/08/2019,11:27:24,08/08/2019,11:27:24,0247 UKT 1303617039 0819/0013469        ,0.00,3950000,7802471257.29,19080800134690000051,
438,08/08/2019,11:27:46,08/08/2019,11:27:46,0247 UKT 1105617026 0819/0008219        ,0.00,500000,7802971257.29,19080800082190000071,
439,08/08/2019,11:29:09,08/08/2019,11:29:09,0247 UKT 1106618072 0819/0016715        ,0.00,6400000,7809371257.29,19080800167150000061,
440,08/08/2019,11:30:14,08/08/2019,11:30:14,0247 UKT 1107617170 0819/0017768        ,0.00,3900000,7813271257.29,19080800177680000045,
441,08/08/2019,11:30:25,08/08/2019,11:30:25,0247 UKT                                ,0.00,5200000,7818471257.29,19080899113810515934,
442,08/08/2019,11:31:34,08/08/2019,11:31:34,0247 UKT 1801617152 0819/0008941        ,0.00,4000000,7822471257.29,19080800089410000066,
443,08/08/2019,11:33:12,08/08/2019,11:33:12,0247 UKT 1801617022 0819/0009574        ,0.00,8200000,7830671257.29,19080800095740000076,
444,08/08/2019,11:37:59,08/08/2019,11:37:59,0247 UKT 1204618025 0819/0013765        ,0.00,5900000,7836571257.29,19080800137650000046,
445,08/08/2019,11:38:47,08/08/2019,11:38:47,0247 UKT 1304617016 0819/0016995        ,0.00,7500000,7844071257.29,19080800169950000175,
446,08/08/2019,11:38:50,08/08/2019,11:38:50,0247 UKT 1801618120 0819/0007337        ,0.00,4000000,7848071257.29,19080800073370000032,
447,08/08/2019,11:41:10,08/08/2019,11:41:10,0247 UKT 1801618094 0819/0013466        ,0.00,7200000,7855271257.29,19080800134660000103,
448,08/08/2019,11:57:49,08/08/2019,11:57:49,0247 UKT 1306617014 0819/0009763        ,0.00,5200000,7860471257.29,19080800097630000048,
449,08/08/2019,12:06:42,08/08/2019,12:06:42,0247 UKT 1106618066 0819/0009627        ,0.00,3900000,7864371257.29,19080800096270000033,
450,08/08/2019,12:26:47,08/08/2019,12:26:47,0247 UKT 1801618155 0819/0006168        ,0.00,8200000,7872571257.29,19080800061680000074,
451,08/08/2019,12:27:04,08/08/2019,12:27:04,0247 UKT 1209618005 0819/0008219        ,0.00,6700000,7879271257.29,19080800082190000074,
452,08/08/2019,12:33:54,08/08/2019,12:33:54,0247 UKT 1106618040 0819/0017965        ,0.00,6400000,7885671257.29,19080800179650000086,
453,08/08/2019,12:42:02,08/08/2019,12:42:02,0247 UKT 1801617034 0819/0013678        ,0.00,4000000,7889671257.29,19080800136780000199,
454,08/08/2019,12:43:10,08/08/2019,12:43:10,0247 UKT                                ,0.00,6000000,7895671257.29,19080899113810072857,
455,08/08/2019,12:51:33,08/08/2019,12:51:33,0247 UKT 1314617020 0819/0017017        ,0.00,4000000,7899671257.29,19080800170170000080,
456,08/08/2019,12:53:13,08/08/2019,12:53:13,0247 UKT 1102617078 0819/0017349        ,0.00,5800000,7905471257.29,19080800173490000199,
457,08/08/2019,12:54:20,08/08/2019,12:54:20,0247 UKT 1801618045 0819/0007348        ,0.00,4000000,7909471257.29,19080800073480000076,
458,08/08/2019,12:54:44,08/08/2019,12:54:44,0247 UKT 1801618101 0819/0007348        ,0.00,4000000,7913471257.29,19080800073480000078,
459,08/08/2019,12:55:57,08/08/2019,12:55:57,0247 UKT 1801617041 0819/0012937        ,0.00,4000000,7917471257.29,19080800129370000013,
460,08/08/2019,13:01:57,08/08/2019,13:01:57,0247 UKT 1105618052 0819/0016586        ,0.00,5800000,7923271257.29,19080800165860000175,
461,08/08/2019,13:05:41,08/08/2019,13:05:41,0247 UKT 1103618058 0819/0017994        ,0.00,5300000,7928571257.29,19080800179940000073,
462,08/08/2019,13:08:29,08/08/2019,13:08:29,0247 UKT 1104617060 0819/0016412        ,0.00,5300000,7933871257.29,19080800164120000105,
463,08/08/2019,13:09:09,08/08/2019,13:09:09,0247 UKT 1202617007 0819/0008219        ,0.00,6400000,7940271257.29,19080800082190000076,
464,08/08/2019,13:11:51,08/08/2019,13:11:51,0247 UKT 1302618015 0819/0008219        ,0.00,6000000,7946271257.29,19080800082190000078,
465,08/08/2019,13:12:49,08/08/2019,13:12:49,0247 UKT 1801617200 0819/0017002        ,0.00,4000000,7950271257.29,19080800170020000110,
466,08/08/2019,13:13:01,08/08/2019,13:13:01,0247 UKT 1106617047 0819/0016484        ,0.00,3900000,7954171257.29,19080800164840000145,
467,08/08/2019,13:15:13,08/08/2019,13:15:13,0247 UKT 1211617045 0819/0017770        ,0.00,5600000,7959771257.29,19080800177700000176,
468,08/08/2019,13:15:50,08/08/2019,13:15:50,0247 UKT 1201617038 0819/0013434        ,0.00,4000000,7963771257.29,19080800134340000051,
469,08/08/2019,13:17:12,08/08/2019,13:17:12,0247 UKT 1207617010 0819/0008219        ,0.00,5900000,7969671257.29,19080800082190000080,
470,08/08/2019,13:17:29,08/08/2019,13:17:29,0247 UKT 1107618110 0819/0010423        ,0.00,5800000,7975471257.29,19080800104230000092,
471,08/08/2019,13:18:18,08/08/2019,13:18:18,0247 UKT 1103618063 0819/0009772        ,0.00,5300000,7980771257.29,19080800097720000098,
472,08/08/2019,13:18:55,08/08/2019,13:18:55,0247 UKT 1207617022 0819/0008219        ,0.00,1000000,7981771257.29,19080800082190000082,
473,08/08/2019,13:20:33,08/08/2019,13:20:33,0247 UKT                                ,0.00,500000,7982271257.29,19080899676010381440,
474,08/08/2019,13:23:17,08/08/2019,13:23:17,0247 UKT 1801618129 0819/0017017        ,0.00,6200000,7988471257.29,19080800170170000085,
475,08/08/2019,13:24:28,08/08/2019,13:24:28,0247 UKT 1201617059 0819/0008219        ,0.00,4700000,7993171257.29,19080800082190000084,
476,08/08/2019,13:24:37,08/08/2019,13:24:37,0247 UKT 1602617081 0819/0008246        ,0.00,4700000,7997871257.29,19080800082460000099,
477,08/08/2019,13:24:48,08/08/2019,13:24:48,0247 UKT 1207618046 0819/0011829        ,0.00,4500000,8002371257.29,19080800118290000110,
478,08/08/2019,13:27:01,08/08/2019,13:27:01,0247 UKT 1102617089 0819/0007248        ,0.00,5100000,8007471257.29,19080800072480000081,
479,08/08/2019,13:37:38,08/08/2019,13:37:38,0247 UKT 1801617024 0819/0016629        ,0.00,6200000,8013671257.29,19080800166290000067,
480,08/08/2019,13:40:19,08/08/2019,13:40:19,0247 UKT 1603617033 0819/0008594        ,0.00,3200000,8016871257.29,19080800085940000040,
481,08/08/2019,13:44:30,08/08/2019,13:44:30,0247 UKT 1102617115 0819/0017783        ,0.00,3000000,8019871257.29,19080800177830000116,
482,08/08/2019,13:53:44,08/08/2019,13:53:44,0247 UKT 1107617065 0819/0008225        ,0.00,1000000,8020871257.29,19080800082250000078,
483,08/08/2019,13:55:01,08/08/2019,13:55:01,0247 UKT 1106617051 0819/0013447        ,0.00,5100000,8025971257.29,19080800134470000065,
484,08/08/2019,13:55:11,08/08/2019,13:55:11,0247 UKT 1102617099 0819/0006789        ,0.00,5100000,8031071257.29,19080800067890000088,
485,08/08/2019,13:55:21,08/08/2019,13:55:21,0247 UKT 1306617035 0819/0008219        ,0.00,6200000,8037271257.29,19080800082190000098,
486,08/08/2019,13:57:18,08/08/2019,13:57:18,0247 UKT 1106617055 0819/0010977        ,0.00,5100000,8042371257.29,19080800109770000155,
487,08/08/2019,13:57:29,08/08/2019,13:57:29,0247 UKT 1205617016 0819/0008219        ,0.00,6400000,8048771257.29,19080800082190000100,
488,08/08/2019,13:58:19,08/08/2019,13:58:19,0247 UKT 1107618143 0819/0013498        ,0.00,5100000,8053871257.29,19080800134980000083,
489,08/08/2019,13:58:50,08/08/2019,13:58:50,0247 UKT 1304618041 0819/0005990        ,0.00,1000000,8054871257.29,19080800059900000106,
490,08/08/2019,13:59:53,08/08/2019,13:59:53,0247 UKT 1801617101 0819/0007348        ,0.00,8200000,8063071257.29,19080800073480000091,
491,08/08/2019,13:59:58,08/08/2019,13:59:58,0247 UKT 1303618072 0819/0013498        ,0.00,6200000,8069271257.29,19080800134980000086,
492,08/08/2019,14:00:01,08/08/2019,14:00:01,0247 UKT 1301618025 0819/0008219        ,0.00,6000000,8075271257.29,19080800082190000102,
493,08/08/2019,14:01:29,08/08/2019,14:01:29,0247 UKT 1304618052 0819/0008219        ,0.00,5200000,8080471257.29,19080800082190000104,
494,08/08/2019,14:01:41,08/08/2019,14:01:41,0247 UKT 1307617015 0819/0013811        ,0.00,500000,8080971257.29,19080800138110000061,
495,08/08/2019,14:02:26,08/08/2019,14:02:26,0247 UKT 1301617019 0819/0008219        ,0.00,5000000,8085971257.29,19080800082190000106,
496,08/08/2019,14:04:23,08/08/2019,14:04:23,0247 UKT 1205617010 0819/0012486        ,0.00,3900000,8089871257.29,19080800124860000078,
497,08/08/2019,14:05:46,08/08/2019,14:05:46,0247 UKT 1101617078 0819/0013080        ,0.00,5300000,8095171257.29,19080800130800000090,
498,08/08/2019,14:06:55,08/08/2019,14:06:55,0247 UKT 1207618011 0819/0008219        ,0.00,7400000,8102571257.29,19080800082190000110,
499,08/08/2019,14:08:37,08/08/2019,14:08:37,0247 UKT 1106617059 0819/0007168        ,0.00,500000,8103071257.29,19080800071680000238,
500,08/08/2019,14:12:43,08/08/2019,14:12:43,0247 UKT 1102618080 0819/0012955        ,0.00,3900000,8106971257.29,19080800129550000076,
501,08/08/2019,14:19:33,08/08/2019,14:19:33,0247 UKT 1801617241 0819/0009772        ,0.00,1000000,8107971257.29,19080800097720000117,
502,08/08/2019,14:19:38,08/08/2019,14:19:38,0247 UKT 1801617121 0819/0008219        ,0.00,4000000,8111971257.29,19080800082190000116,
503,08/08/2019,14:25:33,08/08/2019,14:25:33,0247 UKT 1208618003 0819/0008219        ,0.00,6700000,8118671257.29,19080800082190000120,
504,08/08/2019,14:28:19,08/08/2019,14:28:19,0247 UKT 1801617125 0819/0008219        ,0.00,7200000,8125871257.29,19080800082190000122,
505,08/08/2019,14:29:25,08/08/2019,14:29:25,0247 UKT 1601617147 0819/0008552        ,0.00,4700000,8130571257.29,19080800085520000170,
506,08/08/2019,14:29:31,08/08/2019,14:29:31,0247 UKT 1106618062 0819/0010423        ,0.00,5100000,8135671257.29,19080800104230000119,
507,08/08/2019,14:29:59,08/08/2019,14:29:59,0247 UKT                                ,0.00,4150000,8139821257.29,19080899091060939985,
508,08/08/2019,14:36:45,08/08/2019,14:36:45,0247 UKT 1202617038 0819/0013056        ,0.00,6400000,8146221257.29,19080800130560000072,
509,08/08/2019,14:53:15,08/08/2019,14:53:15,0247 UKT 1106617050 0819/0016670        ,0.00,3000000,8149221257.29,19080800166700000021,
510,08/08/2019,14:55:55,08/08/2019,14:55:55,0247 UKT 1304617068 0819/0008219        ,0.00,6200000,8155421257.29,19080800082190000126,
511,08/08/2019,14:57:53,08/08/2019,14:57:53,0247 UKT                                ,0.00,6250000,8161671257.29,19080899312010159417,
512,08/08/2019,15:02:42,08/08/2019,15:02:42,0247 UKT 1107617061 0819/0016412        ,0.00,6400000,8168071257.29,19080800164120000146,
513,08/08/2019,20:32:12,08/08/2019,20:32:12,0247 UKT                                ,0.00,9000000,8177071257.29,19080899101710694732,
514,09/08/2019,08:07:51,09/08/2019,08:07:51,0247 UKT 1939219001703 0819/0011829     ,0.00,5900000,8182971257.29,19080900118290000003,
515,09/08/2019,08:08:28,09/08/2019,08:08:28,0247 SPU 1939219001703 0819/0011829     ,0.00,27500000,8210471257.29,19080900118290000005,
516,09/08/2019,08:08:51,09/08/2019,08:08:51,0247 UKT 1939119001580 0819/0013069     ,0.00,4150000,8214621257.29,19080900130690000003,
517,09/08/2019,08:08:54,09/08/2019,08:08:54,0247 UKT 1939219000230 0819/0016534     ,0.00,5100000,8219721257.29,19080900165340000002,
518,09/08/2019,08:09:47,09/08/2019,08:09:47,0247 UKT 1939219001454 0819/0008957     ,0.00,2700000,8222421257.29,19080900089570000005,
519,09/08/2019,08:09:51,09/08/2019,08:09:51,0247 UKT 1939119001521 0819/0018029     ,0.00,6200000,8228621257.29,19080900180290000006,
520,09/08/2019,08:09:59,09/08/2019,08:09:59,0247 SPU 1939219000781 0819/0016629     ,0.00,750000,8229371257.29,19080900166290000004,
521,09/08/2019,08:10:06,09/08/2019,08:10:06,0247 SPU 1939119001923 0819/0007168     ,0.00,750000,8230121257.29,19080900071680000003,
522,09/08/2019,08:10:22,09/08/2019,08:10:22,0247 UKT 1939219000781 0819/0016629     ,0.00,4000000,8234121257.29,19080900166290000006,
523,09/08/2019,08:10:38,09/08/2019,08:10:38,0247 UKT 1939119001923 0819/0007168     ,0.00,4000000,8238121257.29,19080900071680000005,
524,09/08/2019,08:11:26,09/08/2019,08:11:26,0247 UKT 1208617012 0819/0009627        ,0.00,6700000,8244821257.29,19080900096270000002,
525,09/08/2019,08:13:11,09/08/2019,08:13:11,0247 UKT 1939119001800 0819/0009627     ,0.00,500000,8245321257.29,19080900096270000004,
526,09/08/2019,08:13:21,09/08/2019,08:13:21,0247 SPU 1939119001521 0819/0018029     ,0.00,750000,8246071257.29,19080900180290000010,
527,09/08/2019,08:14:06,09/08/2019,08:14:06,0247 SPU 1939119002739 0819/0018013     ,0.00,30000000,8276071257.29,19080900180130000004,
528,09/08/2019,08:14:22,09/08/2019,08:14:22,0247 UKT 1939219001471 0819/0016436     ,0.00,4000000,8280071257.29,19080900164360000002,
529,09/08/2019,08:14:44,09/08/2019,08:14:44,0247 UKT 1939119002739 0819/0018013     ,0.00,6200000,8286271257.29,19080900180130000006,
530,09/08/2019,08:15:16,09/08/2019,08:15:16,0247 UKT 1939219016852 0819/0005990     ,0.00,1000000,8287271257.29,19080900059900000002,
531,09/08/2019,08:15:39,09/08/2019,08:15:39,0247 UKT 1939219008482 0819/0011541     ,0.00,5100000,8292371257.29,19080900115410000011,
532,09/08/2019,08:15:49,09/08/2019,08:15:49,0247 SPU 1939119002503 0819/0013811     ,0.00,10000000,8302371257.29,19080900138110000005,
533,09/08/2019,08:15:58,09/08/2019,08:15:58,0247 SPU 1939119003747 0819/0010443     ,0.00,10000000,8312371257.29,19080900104430000003,
534,09/08/2019,08:16:16,09/08/2019,08:16:16,0247 UKT 1939119002503 0819/0013811     ,0.00,3800000,8316171257.29,19080900138110000007,
535,09/08/2019,08:17:03,09/08/2019,08:17:03,0247 UKT 1939219007905 0819/0016437     ,0.00,5100000,8321271257.29,19080900164370000002,
536,09/08/2019,08:17:19,09/08/2019,08:17:19,0247 UKT 1939319000514 0819/0018024     ,0.00,3000000,8324271257.29,19080900180240000002,
537,09/08/2019,08:17:19,09/08/2019,08:17:19,0247 UKT 1939219004649 0819/0008302     ,0.00,5100000,8329371257.29,19080900083020000010,
538,09/08/2019,08:17:26,09/08/2019,08:17:26,0247 UKT 1939119003747 0819/0010443     ,0.00,6250000,8335621257.29,19080900104430000005,
539,09/08/2019,08:17:39,09/08/2019,08:17:39,0247 UKT 1939219003407 0819/0012486     ,0.00,5100000,8340721257.29,19080900124860000006,
540,09/08/2019,08:18:25,09/08/2019,08:18:25,0247 UKT 1939219000172 0819/0008219     ,0.00,6700000,8347421257.29,19080900082190000004,
541,09/08/2019,08:19:48,09/08/2019,08:19:48,0247 UKT 1939219016223 0819/0012927     ,0.00,4500000,8351921257.29,19080900129270000002,
542,09/08/2019,08:20:14,09/08/2019,08:20:14,0247 UKT 1939219009682 0819/0008219     ,0.00,3700000,8355621257.29,19080900082190000006,
543,09/08/2019,08:21:00,09/08/2019,08:21:00,0247 SPU 1939319000545 0819/0018143     ,0.00,5000000,8360621257.29,19080900181430000004,
544,09/08/2019,08:21:56,09/08/2019,08:21:56,0247 UKT 1939319000545 0819/0018143     ,0.00,5900000,8366521257.29,19080900181430000006,
545,09/08/2019,08:22:13,09/08/2019,08:22:13,0247 UKT 1939219009936 0819/0008294     ,0.00,4600000,8371121257.29,19080900082940000012,
546,09/08/2019,08:22:59,09/08/2019,08:22:59,0247 SPU 1939219016223 0819/0012927     ,0.00,1000000,8372121257.29,19080900129270000004,
547,09/08/2019,08:23:01,09/08/2019,08:23:01,0247 UKT 1939219000351 0819/0008219     ,0.00,5300000,8377421257.29,19080900082190000008,
548,09/08/2019,08:23:35,09/08/2019,08:23:35,0247 SPU 1939219000351 0819/0008219     ,0.00,1000000,8378421257.29,19080900082190000011,
549,09/08/2019,08:23:47,09/08/2019,08:23:47,0247 SPU 1939219002525 0819/0011952     ,0.00,750000,8379171257.29,19080900119520000009,
550,09/08/2019,08:24:09,09/08/2019,08:24:09,0247 UKT 1939219002525 0819/0011952     ,0.00,4700000,8383871257.29,19080900119520000011,
551,09/08/2019,08:24:13,09/08/2019,08:24:13,0247 UKT 1939219000484 0819/0012485     ,0.00,4700000,8388571257.29,19080900124850000006,
552,09/08/2019,08:25:38,09/08/2019,08:25:38,0247 UKT 1939219009407 0819/0011824     ,0.00,4000000,8392571257.29,19080900118240000008,
553,09/08/2019,08:25:51,09/08/2019,08:25:51,0247 UKT 1939219007096 0819/0016488     ,0.00,3000000,8395571257.29,19080900164880000006,
554,09/08/2019,08:26:43,09/08/2019,08:26:43,0247 UKT 1939219002871 0819/0017016     ,0.00,1000000,8396571257.29,19080900170160000020,
555,09/08/2019,08:26:51,09/08/2019,08:26:51,0247 SPU 1939219009407 0819/0011824     ,0.00,2500000,8399071257.29,19080900118240000010,
556,09/08/2019,08:27:01,09/08/2019,08:27:01,0247 UKT 1939119004167 0819/0011965     ,0.00,6200000,8405271257.29,19080900119650000006,
557,09/08/2019,08:27:05,09/08/2019,08:27:05,0247 UKT 1939119001816 0819/0006338     ,0.00,4150000,8409421257.29,19080900063380000031,
558,09/08/2019,08:27:40,09/08/2019,08:27:40,0247 UKT 1939219011294 0819/0017996     ,0.00,3000000,8412421257.29,19080900179960000002,
559,09/08/2019,08:27:49,09/08/2019,08:27:49,0247 UKT 1939219002888 0819/0017016     ,0.00,1000000,8413421257.29,19080900170160000022,
560,09/08/2019,08:27:53,09/08/2019,08:27:53,0247 UKT 1939219001049 0819/0013462     ,0.00,3400000,8416821257.29,19080900134620000002,
561,09/08/2019,08:28:43,09/08/2019,08:28:43,0247 SPU 1939219011294 0819/0017996     ,0.00,1000000,8417821257.29,19080900179960000004,
562,09/08/2019,08:28:43,09/08/2019,08:28:43,0247 UKT 1601617040 0819/0008552        ,0.00,4700000,8422521257.29,19080900085520000017,
563,09/08/2019,08:29:13,09/08/2019,08:29:13,0247 UKT 1939219014301 0819/0008219     ,0.00,6200000,8428721257.29,19080900082190000013,
564,09/08/2019,08:29:21,09/08/2019,08:29:21,0247 UKT 1939219012614 0819/0013482     ,0.00,4500000,8433221257.29,19080900134820000004,
565,09/08/2019,08:29:38,09/08/2019,08:29:38,0247 UKT 1939219006123 0819/0008577     ,0.00,4700000,8437921257.29,19080900085770000004,
566,09/08/2019,08:30:07,09/08/2019,08:30:07,0247 UKT 1939219012461 0819/0009621     ,0.00,3900000,8441821257.29,19080900096210000022,
567,09/08/2019,08:30:12,09/08/2019,08:30:12,0247 SPU 1939219006123 0819/0008577     ,0.00,2000000,8443821257.29,19080900085770000006,
568,09/08/2019,08:30:40,09/08/2019,08:30:40,0247 UKT 1939219002675 0819/0016441     ,0.00,5100000,8448921257.29,19080900164410000017,
569,09/08/2019,08:31:01,09/08/2019,08:31:01,0247 UKT 1939319000829 0819/0009621     ,0.00,1000000,8449921257.29,19080900096210000025,
570,09/08/2019,08:31:08,09/08/2019,08:31:08,0247 UKT 1939219011657 0819/0008298     ,0.00,3000000,8452921257.29,19080900082980000002,
571,09/08/2019,08:31:30,09/08/2019,08:31:30,0247 SPU 1939219012614 0819/0013482     ,0.00,2000000,8454921257.29,19080900134820000006,
572,09/08/2019,08:31:30,09/08/2019,08:31:30,0247 UKT 1939119001919 0819/0010961     ,0.00,4150000,8459071257.29,19080900109610000015,
573,09/08/2019,08:32:06,09/08/2019,08:32:06,0247 UKT 1939219012912 0819/0007887     ,0.00,4000000,8463071257.29,19080900078870000004,
574,09/08/2019,08:32:21,09/08/2019,08:32:21,0247 UKT 1939119003182 0819/0018004     ,0.00,4000000,8467071257.29,19080900180040000007,
575,09/08/2019,08:32:24,09/08/2019,08:32:24,0247 SPU 1939119001919 0819/0010961     ,0.00,750000,8467821257.29,19080900109610000017,
576,09/08/2019,08:32:33,09/08/2019,08:32:33,0247 UKT 1939119001830 0819/0008219     ,0.00,6000000,8473821257.29,19080900082190000015,
577,09/08/2019,08:33:03,09/08/2019,08:33:03,0247 SPU 1939119001830 0819/0008219     ,0.00,7500000,8481321257.29,19080900082190000017,
578,09/08/2019,08:33:14,09/08/2019,08:33:14,0247 UKT 1939219016843 0819/0008298     ,0.00,3000000,8484321257.29,19080900082980000004,
579,09/08/2019,08:33:53,09/08/2019,08:33:53,0247 UKT 1939219000241 0819/0013467     ,0.00,1000000,8485321257.29,19080900134670000003,
580,09/08/2019,08:34:10,09/08/2019,08:34:10,0247 UKT 1939219012137 0819/0013482     ,0.00,1000000,8486321257.29,19080900134820000008,
581,09/08/2019,08:34:13,09/08/2019,08:34:13,0247 UKT 1939219000091 0819/0007348     ,0.00,5100000,8491421257.29,19080900073480000006,
582,09/08/2019,08:34:35,09/08/2019,08:34:35,0247 UKT 1939219009271 0819/0008219     ,0.00,500000,8491921257.29,19080900082190000019,
583,09/08/2019,08:35:44,09/08/2019,08:35:44,0247 SPU 1939119002435 0819/0012479     ,0.00,1000000,8492921257.29,19080900124790000003,
584,09/08/2019,08:36:03,09/08/2019,08:36:03,0247 UKT 1939219014531 0819/0011542     ,0.00,6000000,8498921257.29,19080900115420000025,
585,09/08/2019,08:36:11,09/08/2019,08:36:11,0247 UKT 1939119002435 0819/0012479     ,0.00,4500000,8503421257.29,19080900124790000005,
586,09/08/2019,08:36:24,09/08/2019,08:36:24,0247 UKT 1313617029 0819/0008219        ,0.00,6200000,8509621257.29,19080900082190000021,
587,09/08/2019,08:37:18,09/08/2019,08:37:18,0247 UKT 1939219014939 0819/0011914     ,0.00,4700000,8514321257.29,19080900119140000005,
588,09/08/2019,08:37:47,09/08/2019,08:37:47,0247 SPU 1939219014939 0819/0011914     ,0.00,2000000,8516321257.29,19080900119140000007,
589,09/08/2019,08:38:11,09/08/2019,08:38:11,0247 UKT 1801617185 0819/0017968        ,0.00,4000000,8520321257.29,19080900179680000023,
590,09/08/2019,08:39:27,09/08/2019,08:39:27,0247 UKT 1939219001863 0819/0011824     ,0.00,9300000,8529621257.29,19080900118240000020,
591,09/08/2019,08:40:46,09/08/2019,08:40:46,0247 UKT 1939219010675 0819/0013482     ,0.00,3400000,8533021257.29,19080900134820000013,
592,09/08/2019,08:41:21,09/08/2019,08:41:21,0247 UKT 1939219001093 0819/0008594     ,0.00,5900000,8538921257.29,19080900085940000006,
593,09/08/2019,08:41:23,09/08/2019,08:41:23,0247 SPU 1939219010675 0819/0013482     ,0.00,750000,8539671257.29,19080900134820000015,
594,09/08/2019,08:41:31,09/08/2019,08:41:31,0247 UKT 1939119002998 0819/0009669     ,0.00,1000000,8540671257.29,19080900096690000011,
595,09/08/2019,08:41:46,09/08/2019,08:41:46,0247 SPU 1939219014123 0819/0007348     ,0.00,750000,8541421257.29,19080900073480000011,
596,09/08/2019,08:41:51,09/08/2019,08:41:51,0247 UKT 1939319000818 0819/0012490     ,0.00,5100000,8546521257.29,19080900124900000005,
597,09/08/2019,08:42:05,09/08/2019,08:42:05,0247 UKT 1939219014123 0819/0007348     ,0.00,4000000,8550521257.29,19080900073480000013,
598,09/08/2019,08:42:15,09/08/2019,08:42:15,0247 UKT 1939219009334 0819/0008219     ,0.00,5600000,8556121257.29,19080900082190000023,
599,09/08/2019,08:42:46,09/08/2019,08:42:46,0247 UKT 1939119001491 0819/0017017     ,0.00,6000000,8562121257.29,19080900170170000009,
600,09/08/2019,08:42:54,09/08/2019,08:42:54,0247 SPU 1939219009334 0819/0008219     ,0.00,7500000,8569621257.29,19080900082190000026,
601,09/08/2019,08:43:04,09/08/2019,08:43:04,0247 UKT 1107617051 0819/0016488        ,0.00,3000000,8572621257.29,19080900164880000008,
602,09/08/2019,08:43:18,09/08/2019,08:43:18,0247 UKT 1939219000722 0819/0007367     ,0.00,5900000,8578521257.29,19080900073670000017,
603,09/08/2019,08:43:19,09/08/2019,08:43:19,0247 SPU 1939119001491 0819/0017017     ,0.00,1000000,8579521257.29,19080900170170000011,
604,09/08/2019,08:43:21,09/08/2019,08:43:21,0247 UKT 1801617139 0819/0017789        ,0.00,4000000,8583521257.29,19080900177890000007,
605,09/08/2019,08:44:19,09/08/2019,08:44:19,0247 SPU 1939219001093 0819/0008594     ,0.00,750000,8584271257.29,19080900085940000008,
606,09/08/2019,08:44:26,09/08/2019,08:44:26,0247 UKT 1939219004155 0819/0008573     ,0.00,8200000,8592471257.29,19080900085730000010,
607,09/08/2019,08:44:40,09/08/2019,08:44:40,0247 UKT 1801618114 0819/0008219        ,0.00,4000000,8596471257.29,19080900082190000028,
608,09/08/2019,08:45:12,09/08/2019,08:45:12,0247 SPU 1939219000722 0819/0007367     ,0.00,1000000,8597471257.29,19080900073670000019,
609,09/08/2019,08:45:50,09/08/2019,08:45:50,0247 SPU 1939219004155 0819/0008573     ,0.00,1000000,8598471257.29,19080900085730000012,
610,09/08/2019,08:46:33,09/08/2019,08:46:33,0247 UKT 1939219000140 0819/0012246     ,0.00,6700000,8605171257.29,19080900122460000007,
611,09/08/2019,08:46:41,09/08/2019,08:46:41,0247 UKT 1302617058 0819/0008219        ,0.00,3800000,8608971257.29,19080900082190000030,
612,09/08/2019,08:47:19,09/08/2019,08:47:19,0247 UKT 1939219005964 0819/0017996     ,0.00,3900000,8612871257.29,19080900179960000008,
613,09/08/2019,08:47:39,09/08/2019,08:47:39,0247 SPU 1939219005964 0819/0017996     ,0.00,750000,8613621257.29,19080900179960000010,
614,09/08/2019,08:48:08,09/08/2019,08:48:08,0247 SPU 1939219000140 0819/0012246     ,0.00,5000000,8618621257.29,19080900122460000009,
615,09/08/2019,08:48:28,09/08/2019,08:48:28,0247 UKT 1939119002701 0819/0008219     ,0.00,6200000,8624821257.29,19080900082190000032,
616,09/08/2019,08:48:30,09/08/2019,08:48:30,0247 SPU 1939219006404 0819/0018015     ,0.00,750000,8625571257.29,19080900180150000005,
617,09/08/2019,08:48:48,09/08/2019,08:48:48,0247 UKT 1304617051 0819/0016543        ,0.00,4500000,8630071257.29,19080900165430000013,
618,09/08/2019,08:49:03,09/08/2019,08:49:03,0247 UKT 1939219006404 0819/0018015     ,0.00,4000000,8634071257.29,19080900180150000007,
619,09/08/2019,08:50:33,09/08/2019,08:50:33,0247 UKT 1939119002057 0819/0008219     ,0.00,6200000,8640271257.29,19080900082190000034,
620,09/08/2019,08:50:55,09/08/2019,08:50:55,0247 SPU 1939119002057 0819/0008219     ,0.00,15000000,8655271257.29,19080900082190000036,
621,09/08/2019,08:50:56,09/08/2019,08:50:56,0247 UKT 1939219005823 0819/0007362     ,0.00,4700000,8659971257.29,19080900073620000006,
622,09/08/2019,08:51:12,09/08/2019,08:51:12,0247 UKT 1107617137 0819/0013048        ,0.00,6400000,8666371257.29,19080900130480000031,
623,09/08/2019,08:51:44,09/08/2019,08:51:44,0247 UKT 1939119003167 0819/0016722     ,0.00,1000000,8667371257.29,19080900167220000006,
624,09/08/2019,08:52:29,09/08/2019,08:52:29,0247 UKT 1939119001366 0819/0018019     ,0.00,1000000,8668371257.29,19080900180190000002,
625,09/08/2019,08:52:30,09/08/2019,08:52:30,0247 UKT 1939119003445 0819/0005990     ,0.00,6250000,8674621257.29,19080900059900000009,
626,09/08/2019,08:53:33,09/08/2019,08:53:33,0247 UKT 1939319000470 0819/0013062     ,0.00,5300000,8679921257.29,19080900130620000020,
627,09/08/2019,08:54:01,09/08/2019,08:54:01,0247 SPU 1939319000470 0819/0013062     ,0.00,1000000,8680921257.29,19080900130620000022,
628,09/08/2019,08:54:45,09/08/2019,08:54:45,0247 UKT 1939219000872 0819/0018005     ,0.00,4500000,8685421257.29,19080900180050000008,
629,09/08/2019,08:55:28,09/08/2019,08:55:28,0247 UKT 1939119000975 0819/0013069     ,0.00,6200000,8691621257.29,19080900130690000010,
630,09/08/2019,08:55:54,09/08/2019,08:55:54,0247 UKT 1939219007942 0819/0008219     ,0.00,4000000,8695621257.29,19080900082190000038,
631,09/08/2019,08:58:21,09/08/2019,08:58:21,0247 UKT 1939319000702 0819/0013467     ,0.00,5200000,8700821257.29,19080900134670000014,
632,09/08/2019,08:58:28,09/08/2019,08:58:28,0247 UKT 1939219005540 0819/0017996     ,0.00,5900000,8706721257.29,19080900179960000012,
633,09/08/2019,08:58:48,09/08/2019,08:58:48,0247 SPU 1939219005540 0819/0017996     ,0.00,1500000,8708221257.29,19080900179960000014,
634,09/08/2019,08:59:09,09/08/2019,08:59:09,0247 UKT 1939219010147 0819/0012490     ,0.00,5900000,8714121257.29,19080900124900000011,
635,09/08/2019,08:59:18,09/08/2019,08:59:18,0247 SPU 1939219004377 0819/0016529     ,0.00,750000,8714871257.29,19080900165290000020,
636,09/08/2019,08:59:41,09/08/2019,08:59:41,0247 SPU 1939119003466 0819/0009772     ,0.00,5000000,8719871257.29,19080900097720000023,
637,09/08/2019,09:00:05,09/08/2019,09:00:05,0247 UKT 1939119003466 0819/0009772     ,0.00,3800000,8723671257.29,19080900097720000025,
638,09/08/2019,09:00:06,09/08/2019,09:00:06,0247 UKT 1939219011623 0819/0012486     ,0.00,1000000,8724671257.29,19080900124860000010,
639,09/08/2019,09:00:36,09/08/2019,09:00:36,0247 UKT 1939219004377 0819/0016529     ,0.00,3900000,8728571257.29,19080900165290000022,
640,09/08/2019,09:00:58,09/08/2019,09:00:58,0247 UKT 1939219011157 0819/0008555     ,0.00,3000000,8731571257.29,19080900085550000007,
641,09/08/2019,09:01:00,09/08/2019,09:01:00,0247 UKT 1939319000681 0819/0017770     ,0.00,8200000,8739771257.29,19080900177700000052,
642,09/08/2019,09:01:16,09/08/2019,09:01:16,0247 UKT 1939219009554 0819/0016700     ,0.00,1000000,8740771257.29,19080900167000000020,
643,09/08/2019,09:01:39,09/08/2019,09:01:39,0247 UKT 1939219003369 0819/0006664     ,0.00,5300000,8746071257.29,19080900066640000011,
644,09/08/2019,09:01:51,09/08/2019,09:01:51,0247 UKT 1939119001598 0819/0016683     ,0.00,3200000,8749271257.29,19080900166830000008,
645,09/08/2019,09:02:33,09/08/2019,09:02:33,0247 UKT 1939219012384 0819/0013506     ,0.00,3000000,8752271257.29,19080900135060000032,
646,09/08/2019,09:02:44,09/08/2019,09:02:44,0247 SPU 1939219010147 0819/0012490     ,0.00,3000000,8755271257.29,19080900124900000014,
647,09/08/2019,09:04:10,09/08/2019,09:04:10,0247 SPU 1939219012384 0819/0013506     ,0.00,750000,8756021257.29,19080900135060000035,
648,09/08/2019,09:04:15,09/08/2019,09:04:15,0247 UKT 1939319000615 0819/0008219     ,0.00,500000,8756521257.29,19080900082190000040,
649,09/08/2019,09:04:23,09/08/2019,09:04:23,0247 UKT 1939219006244 0819/0016438     ,0.00,3000000,8759521257.29,19080900164380000013,
650,09/08/2019,09:04:34,09/08/2019,09:04:34,0247 UKT 1939219008829 0819/0010423     ,0.00,5600000,8765121257.29,19080900104230000015,
651,09/08/2019,09:04:52,09/08/2019,09:04:52,0247 SPU 1939319000615 0819/0008219     ,0.00,5000000,8770121257.29,19080900082190000042,
652,09/08/2019,09:04:55,09/08/2019,09:04:55,0247 UKT 1313617008 0819/0012474        ,0.00,6200000,8776321257.29,19080900124740000039,
653,09/08/2019,09:05:12,09/08/2019,09:05:12,0247 UKT 1939219016558 0819/0007754     ,0.00,3000000,8779321257.29,19080900077540000030,
654,09/08/2019,09:05:14,09/08/2019,09:05:14,0247 SPU 1939219008829 0819/0010423     ,0.00,1000000,8780321257.29,19080900104230000017,
655,09/08/2019,09:05:16,09/08/2019,09:05:16,0247 UKT 1106618019 0819/0016412        ,0.00,5100000,8785421257.29,19080900164120000013,
656,09/08/2019,09:05:28,09/08/2019,09:05:28,0247 UKT 1939219004370 0819/0008547     ,0.00,5100000,8790521257.29,19080900085470000007,
657,09/08/2019,09:05:59,09/08/2019,09:05:59,0247 UKT 1939219004374 0819/0012236     ,0.00,6900000,8797421257.29,19080900122360000007,
658,09/08/2019,09:06:47,09/08/2019,09:06:47,0247 UKT 1939219005940 0819/0012245     ,0.00,5300000,8802721257.29,19080900122450000018,
659,09/08/2019,09:07:40,09/08/2019,09:07:40,0247 UKT 1939119001545 0819/0007348     ,0.00,6250000,8808971257.29,19080900073480000020,
660,09/08/2019,09:08:00,09/08/2019,09:08:00,0247 SPU 1939119001545 0819/0007348     ,0.00,750000,8809721257.29,19080900073480000022,
661,09/08/2019,09:08:17,09/08/2019,09:08:17,0247 UKT 1939119000835 0819/0010971     ,0.00,8000000,8817721257.29,19080900109710000006,
662,09/08/2019,09:08:19,09/08/2019,09:08:19,0247 SPU 1939219005940 0819/0012245     ,0.00,750000,8818471257.29,19080900122450000020,
663,09/08/2019,09:08:49,09/08/2019,09:08:49,0247 UKT 1939219007606 0819/0013467     ,0.00,3000000,8821471257.29,19080900134670000025,
664,09/08/2019,09:10:07,09/08/2019,09:10:07,0247 SPU 1939219007606 0819/0013467     ,0.00,750000,8822221257.29,19080900134670000027,
665,09/08/2019,09:10:20,09/08/2019,09:10:20,0247 UKT 1939219013929 0819/0012245     ,0.00,3000000,8825221257.29,19080900122450000022,
666,09/08/2019,09:10:24,09/08/2019,09:10:24,0247 UKT 1939119001931 0819/0011932     ,0.00,6200000,8831421257.29,19080900119320000008,
667,09/08/2019,09:10:48,09/08/2019,09:10:48,0247 SPU 1939219009043 0819/0009770     ,0.00,1000000,8832421257.29,19080900097700000054,
668,09/08/2019,09:10:56,09/08/2019,09:10:56,0247 UKT 1939319000531 0819/0012479     ,0.00,7400000,8839821257.29,19080900124790000013,
669,09/08/2019,09:11:11,09/08/2019,09:11:11,0247 UKT 1939219009043 0819/0009770     ,0.00,5200000,8845021257.29,19080900097700000056,
670,09/08/2019,09:11:33,09/08/2019,09:11:33,0247 UKT 1939219000810 0819/0011829     ,0.00,5100000,8850121257.29,19080900118290000020,
671,09/08/2019,09:11:38,09/08/2019,09:11:38,0247 UKT 1939219010480 0819/0016631     ,0.00,2700000,8852821257.29,19080900166310000007,
672,09/08/2019,09:11:59,09/08/2019,09:11:59,0247 UKT 1939219014417 0819/0008219     ,0.00,3000000,8855821257.29,19080900082190000044,
673,09/08/2019,09:12:01,09/08/2019,09:12:01,0247 UKT 1939219005005 0819/0016999     ,0.00,4500000,8860321257.29,19080900169990000033,
674,09/08/2019,09:12:08,09/08/2019,09:12:08,0247 SPU 1939219010480 0819/0016631     ,0.00,1000000,8861321257.29,19080900166310000009,
675,09/08/2019,09:12:17,09/08/2019,09:12:17,0247 SPU 1939219000810 0819/0011829     ,0.00,750000,8862071257.29,19080900118290000022,
676,09/08/2019,09:12:19,09/08/2019,09:12:19,0247 UKT 1939119001678 0819/0007887     ,0.00,6200000,8868271257.29,19080900078870000014,
677,09/08/2019,09:12:47,09/08/2019,09:12:47,0247 UKT 1939219008005 0819/0007366     ,0.00,2700000,8870971257.29,19080900073660000021,
678,09/08/2019,09:13:03,09/08/2019,09:13:03,0247 UKT 1939219002203 0819/0016545     ,0.00,8200000,8879171257.29,19080900165450000045,
679,09/08/2019,09:13:07,09/08/2019,09:13:07,0247 SPU 1939219014417 0819/0008219     ,0.00,750000,8879921257.29,19080900082190000046,
680,09/08/2019,09:13:13,09/08/2019,09:13:13,0247 UKT 1939219007298 0819/0013080     ,0.00,5100000,8885021257.29,19080900130800000011,
681,09/08/2019,09:13:28,09/08/2019,09:13:28,0247 SPU 1939119001678 0819/0007887     ,0.00,1000000,8886021257.29,19080900078870000016,
682,09/08/2019,09:13:53,09/08/2019,09:13:53,0247 SPU 1939219008005 0819/0007366     ,0.00,760000,8886781257.29,19080900073660000023,
683,09/08/2019,09:13:58,09/08/2019,09:13:58,0247 UKT 1202618024 0819/0016438        ,0.00,3900000,8890681257.29,19080900164380000015,
684,09/08/2019,09:14:10,09/08/2019,09:14:10,0247 UKT 1939219008152 0819/0016629     ,0.00,1000000,8891681257.29,19080900166290000016,
685,09/08/2019,09:14:15,09/08/2019,09:14:15,0247 UKT 1939219007631 0819/0010971     ,0.00,5100000,8896781257.29,19080900109710000008,
686,09/08/2019,09:14:38,09/08/2019,09:14:38,0247 UKT 1939119000847 0819/0008236     ,0.00,6200000,8902981257.29,19080900082360000042,
687,09/08/2019,09:15:23,09/08/2019,09:15:23,0247 UKT 1939119001705 0819/0008219     ,0.00,1000000,8903981257.29,19080900082190000048,
688,09/08/2019,09:15:31,09/08/2019,09:15:31,0247 UKT 1939219008019 0819/0008552     ,0.00,1000000,8904981257.29,19080900085520000042,
689,09/08/2019,09:15:35,09/08/2019,09:15:35,0247 UKT 1939219009879 0819/0011932     ,0.00,4000000,8908981257.29,19080900119320000010,
690,09/08/2019,09:15:39,09/08/2019,09:15:39,0247 SPU 1939219008096 0819/0009551     ,0.00,750000,8909731257.29,19080900095510000017,
691,09/08/2019,09:16:08,09/08/2019,09:16:08,0247 SPU 1939219007298 0819/0013080     ,0.00,10000000,8919731257.29,19080900130800000013,
692,09/08/2019,09:16:11,09/08/2019,09:16:11,0247 UKT 1939219008096 0819/0009551     ,0.00,4700000,8924431257.29,19080900095510000019,
693,09/08/2019,09:16:19,09/08/2019,09:16:19,0247 UKT 1939219011735 0819/0008219     ,0.00,1000000,8925431257.29,19080900082190000050,
694,09/08/2019,09:16:35,09/08/2019,09:16:35,0247 UKT 1939219008254 0819/0013056     ,0.00,6400000,8931831257.29,19080900130560000016,
695,09/08/2019,09:17:17,09/08/2019,09:17:17,0247 SPU 1939219008254 0819/0013056     ,0.00,3000000,8934831257.29,19080900130560000018,
696,09/08/2019,09:17:18,09/08/2019,09:17:18,0247 UKT 1102617106 0819/0008219        ,0.00,3900000,8938731257.29,19080900082190000052,
697,09/08/2019,09:18:06,09/08/2019,09:18:06,0247 SPU 1939219007631 0819/0010971     ,0.00,750000,8939481257.29,19080900109710000012,
698,09/08/2019,09:18:06,09/08/2019,09:18:06,0247 SPU 1939219009879 0819/0011932     ,0.00,10000000,8949481257.29,19080900119320000012,
699,09/08/2019,09:18:13,09/08/2019,09:18:13,0247 UKT 1939219008169 0819/0009558     ,0.00,3200000,8952681257.29,19080900095580000006,
700,09/08/2019,09:18:43,09/08/2019,09:18:43,0247 UKT 1939219003631 0819/0008236     ,0.00,3900000,8956581257.29,19080900082360000044,
701,09/08/2019,09:18:55,09/08/2019,09:18:55,0247 UKT 1939119001749 0819/0012489     ,0.00,5200000,8961781257.29,19080900124890000014,
702,09/08/2019,09:20:09,09/08/2019,09:20:09,0247 UKT 1939219007262 0819/0008219     ,0.00,3200000,8964981257.29,19080900082190000054,
703,09/08/2019,09:20:30,09/08/2019,09:20:30,0247 SPU 1939219007262 0819/0008219     ,0.00,750000,8965731257.29,19080900082190000056,
704,09/08/2019,09:20:35,09/08/2019,09:20:35,0247 UKT 1939219012202 0819/0017968     ,0.00,1000000,8966731257.29,19080900179680000031,
705,09/08/2019,09:20:37,09/08/2019,09:20:37,0247 UKT 1939219010469 0819/0013502     ,0.00,4000000,8970731257.29,19080900135020000012,
706,09/08/2019,09:21:04,09/08/2019,09:21:04,0247 UKT 1939219010482 0819/0010423     ,0.00,3900000,8974631257.29,19080900104230000021,
707,09/08/2019,09:21:12,09/08/2019,09:21:12,0247 SPU 1939119001749 0819/0012489     ,0.00,1000000,8975631257.29,19080900124890000016,
708,09/08/2019,09:22:14,09/08/2019,09:22:14,0247 UKT 1939219003231 0819/0006635     ,0.00,5100000,8980731257.29,19080900066350000027,
709,09/08/2019,09:22:27,09/08/2019,09:22:27,0247 UKT 1939319000285 0819/0013066     ,0.00,3200000,8983931257.29,19080900130660000012,
710,09/08/2019,09:22:33,09/08/2019,09:22:33,0247 UKT 1939119002860 0819/0008948     ,0.00,6200000,8990131257.29,19080900089480000008,
711,09/08/2019,09:22:50,09/08/2019,09:22:50,0247 SPU 1939219010160 0819/0012882     ,0.00,750000,8990881257.29,19080900128820000029,
712,09/08/2019,09:22:50,09/08/2019,09:22:50,0247 UKT 1939219008973 0819/0016484     ,0.00,5400000,8996281257.29,19080900164840000070,
713,09/08/2019,09:23:08,09/08/2019,09:23:08,0247 SPU 1939319000285 0819/0013066     ,0.00,750000,8997031257.29,19080900130660000015,
714,09/08/2019,09:23:18,09/08/2019,09:23:18,0247 UKT 1939219010160 0819/0012882     ,0.00,6400000,9003431257.29,19080900128820000031,
715,09/08/2019,09:23:26,09/08/2019,09:23:26,0247 UKT 1939219000573 0819/0008219     ,0.00,8200000,9011631257.29,19080900082190000058,
716,09/08/2019,09:23:39,09/08/2019,09:23:39,0247 SPU 1939119002341 0819/0016659     ,0.00,755000,9012386257.29,19080900166590000030,
717,09/08/2019,09:23:56,09/08/2019,09:23:56,0247 SPU 1939219000573 0819/0008219     ,0.00,750000,9013136257.29,19080900082190000060,
718,09/08/2019,09:24:09,09/08/2019,09:24:09,0247 UKT 1939119002341 0819/0016659     ,0.00,6000000,9019136257.29,19080900166590000032,
719,09/08/2019,09:24:30,09/08/2019,09:24:30,0247 UKT 1939219010021 0819/0007887     ,0.00,5100000,9024236257.29,19080900078870000025,
720,09/08/2019,09:24:54,09/08/2019,09:24:54,0247 UKT 1939119003075 0819/0013051     ,0.00,6200000,9030436257.29,19080900130510000023,
721,09/08/2019,09:24:58,09/08/2019,09:24:58,0247 SPU 1939219010021 0819/0007887     ,0.00,1000000,9031436257.29,19080900078870000027,
722,09/08/2019,09:25:14,09/08/2019,09:25:14,0247 UKT 1939219005201 0819/0013054     ,0.00,5100000,9036536257.29,19080900130540000006,
723,09/08/2019,09:26:38,09/08/2019,09:26:38,0247 UKT 1939219011617 0819/0008219     ,0.00,5100000,9041636257.29,19080900082190000062,
724,09/08/2019,09:26:56,09/08/2019,09:26:56,0247 SPU 1939219011617 0819/0008219     ,0.00,1500000,9043136257.29,19080900082190000064,
725,09/08/2019,09:27:36,09/08/2019,09:27:36,0247 UKT 1939319000849 0819/0013678     ,0.00,1000000,9044136257.29,19080900136780000058,
726,09/08/2019,09:28:01,09/08/2019,09:28:01,0247 UKT 1939119001552 0819/0017989     ,0.00,3800000,9047936257.29,19080900179890000036,
727,09/08/2019,09:28:19,09/08/2019,09:28:19,0247 UKT 1939219000235 0819/0008219     ,0.00,5900000,9053836257.29,19080900082190000066,
728,09/08/2019,09:28:23,09/08/2019,09:28:23,0247 UKT 1939219001320 0819/0016534     ,0.00,3000000,9056836257.29,19080900165340000014,
729,09/08/2019,09:29:31,09/08/2019,09:29:31,0247 UKT 1939219013294 0819/0008219     ,0.00,5100000,9061936257.29,19080900082190000068,
730,09/08/2019,09:29:47,09/08/2019,09:29:47,0247 UKT 1939219008141 0819/0016660     ,0.00,500000,9062436257.29,19080900166600000015,
731,09/08/2019,09:30:19,09/08/2019,09:30:19,0247 UKT 1939219013737 0819/0009746     ,0.00,4500000,9066936257.29,19080900097460000017,
732,09/08/2019,09:30:23,09/08/2019,09:30:23,0247 UKT 1939319000887 0819/0013175     ,0.00,6200000,9073136257.29,19080900131750000057,
733,09/08/2019,09:31:08,09/08/2019,09:31:08,0247 UKT 1801617254 0819/0008591        ,0.00,8200000,9081336257.29,19080900085910000022,
734,09/08/2019,09:31:40,09/08/2019,09:31:40,0247 UKT 1939219005211 0819/0008219     ,0.00,6700000,9088036257.29,19080900082190000070,
735,09/08/2019,09:31:44,09/08/2019,09:31:44,0247 UKT 1939219008246 0819/0016490     ,0.00,5300000,9093336257.29,19080900164900000011,
736,09/08/2019,09:31:50,09/08/2019,09:31:50,0247 UKT 1939119001682 0819/0007362     ,0.00,4000000,9097336257.29,19080900073620000030,
737,09/08/2019,09:31:59,09/08/2019,09:31:59,0247 SPU 1939219005211 0819/0008219     ,0.00,1000000,9098336257.29,19080900082190000072,
738,09/08/2019,09:32:29,09/08/2019,09:32:29,0247 UKT 1801617107 0819/0007012        ,0.00,4000000,9102336257.29,19080900070120000043,
739,09/08/2019,09:32:58,09/08/2019,09:32:58,0247 UKT 1939219009759 0819/0008219     ,0.00,1000000,9103336257.29,19080900082190000074,
740,09/08/2019,09:33:03,09/08/2019,09:33:03,0247 UKT 1939119003992 0819/0012233     ,0.00,3800000,9107136257.29,19080900122330000059,
741,09/08/2019,09:33:43,09/08/2019,09:33:43,0247 SPU 1939219008246 0819/0016490     ,0.00,1500000,9108636257.29,19080900164900000014,
742,09/08/2019,09:33:46,09/08/2019,09:33:46,0247 UKT 1601617094 0819/0013056        ,0.00,500000,9109136257.29,19080900130560000020,
743,09/08/2019,09:33:49,09/08/2019,09:33:49,0247 UKT 1939219013549 0819/0008219     ,0.00,1000000,9110136257.29,19080900082190000076,
744,09/08/2019,09:34:06,09/08/2019,09:34:06,0247 UKT 1939219017358 0819/0018024     ,0.00,1000000,9111136257.29,19080900180240000012,
745,09/08/2019,09:35:10,09/08/2019,09:35:10,0247 UKT 1939219010233 0819/0009612     ,0.00,500000,9111636257.29,19080900096120000010,
746,09/08/2019,09:35:45,09/08/2019,09:35:45,0247 UKT 1939119002058 0819/0010977     ,0.00,10000000,9121636257.29,19080900109770000024,
747,09/08/2019,09:36:18,09/08/2019,09:36:18,0247 SPU 1939219010233 0819/0009612     ,0.00,2000000,9123636257.29,19080900096120000012,
748,09/08/2019,09:36:32,09/08/2019,09:36:32,0247 UKT 1939219010397 0819/0017989     ,0.00,4500000,9128136257.29,19080900179890000039,
749,09/08/2019,09:36:35,09/08/2019,09:36:35,0247 UKT 1939219007426 0819/0012486     ,0.00,6700000,9134836257.29,19080900124860000015,
750,09/08/2019,09:37:10,09/08/2019,09:37:10,0247 UKT 1939219007439 0819/0017984     ,0.00,5100000,9139936257.29,19080900179840000013,
751,09/08/2019,09:37:57,09/08/2019,09:37:57,0247 SPU 1939319000229 0819/0012490     ,0.00,2500000,9142436257.29,19080900124900000022,
752,09/08/2019,09:39:09,09/08/2019,09:39:09,0247 UKT 1939319000229 0819/0012490     ,0.00,6400000,9148836257.29,19080900124900000024,
753,09/08/2019,09:39:23,09/08/2019,09:39:23,0247 SPU 1939219010397 0819/0017989     ,0.00,750000,9149586257.29,19080900179890000041,
754,09/08/2019,09:40:14,09/08/2019,09:40:14,0247 UKT 1939219010223 0819/0016660     ,0.00,1000000,9150586257.29,19080900166600000017,
755,09/08/2019,09:41:49,09/08/2019,09:41:49,0247 UKT 1939219012891 0819/0018015     ,0.00,5600000,9156186257.29,19080900180150000022,
756,09/08/2019,09:41:55,09/08/2019,09:41:55,0247 SPU 1939219010681 0819/0018000     ,0.00,1000000,9157186257.29,19080900180000000007,
757,09/08/2019,09:42:16,09/08/2019,09:42:16,0247 SPU 1939219012891 0819/0018015     ,0.00,1000000,9158186257.29,19080900180150000024,
758,09/08/2019,09:42:25,09/08/2019,09:42:25,0247 UKT 1939119000898 0819/0016441     ,0.00,6000000,9164186257.29,19080900164410000060,
759,09/08/2019,09:42:31,09/08/2019,09:42:31,0247 UKT 1939219010681 0819/0018000     ,0.00,3000000,9167186257.29,19080900180000000009,
760,09/08/2019,09:42:32,09/08/2019,09:42:32,0247 UKT 1939119001456 0819/0009574     ,0.00,6200000,9173386257.29,19080900095740000052,
761,09/08/2019,09:43:36,09/08/2019,09:43:36,0247 SPU 1939219009313 0819/0016717     ,0.00,7000000,9180386257.29,19080900167170000013,
762,09/08/2019,09:43:57,09/08/2019,09:43:57,0247 UKT 1939219013875 0819/0007337     ,0.00,6200000,9186586257.29,19080900073370000026,
763,09/08/2019,09:44:06,09/08/2019,09:44:06,0247 UKT 1939219009313 0819/0016717     ,0.00,5300000,9191886257.29,19080900167170000015,
764,09/08/2019,09:44:28,09/08/2019,09:44:28,0247 UKT 1939219004899 0819/0007900     ,0.00,4500000,9196386257.29,19080900079000000039,
765,09/08/2019,09:44:30,09/08/2019,09:44:30,0247 UKT 1939119003125 0819/0016533     ,0.00,500000,9196886257.29,19080900165330000017,
766,09/08/2019,09:45:11,09/08/2019,09:45:11,0247 SPU 1939319000179 0819/0018029     ,0.00,3000000,9199886257.29,19080900180290000140,
767,09/08/2019,09:45:46,09/08/2019,09:45:46,0247 UKT 1939319000179 0819/0018029     ,0.00,6400000,9206286257.29,19080900180290000142,
768,09/08/2019,09:46:06,09/08/2019,09:46:06,0247 SPU 1939119003125 0819/0016533     ,0.00,750000,9207036257.29,19080900165330000021,
769,09/08/2019,09:46:07,09/08/2019,09:46:07,0247 SPU 1939219007360 0819/0008242     ,0.00,1500000,9208536257.29,19080900082420000005,
770,09/08/2019,09:46:10,09/08/2019,09:46:10,0247 UKT 1939219016886 0819/0017013     ,0.00,4700000,9213236257.29,19080900170130000024,
771,09/08/2019,09:46:47,09/08/2019,09:46:47,0247 UKT 1939219007360 0819/0008242     ,0.00,6400000,9219636257.29,19080900082420000007,
772,09/08/2019,09:46:49,09/08/2019,09:46:49,0247 UKT 1801617192 0819/0008557        ,0.00,7200000,9226836257.29,19080900085570000020,
773,09/08/2019,09:47:52,09/08/2019,09:47:52,0247 UKT 1939219016946 0819/0012245     ,0.00,5100000,9231936257.29,19080900122450000045,
774,09/08/2019,09:48:48,09/08/2019,09:48:48,0247 SPU 1939219016946 0819/0012245     ,0.00,7000000,9238936257.29,19080900122450000048,
775,09/08/2019,09:48:59,09/08/2019,09:48:59,0247 UKT 1939219002468 0819/0013765     ,0.00,6000000,9244936257.29,19080900137650000028,
776,09/08/2019,09:49:37,09/08/2019,09:49:37,0247 SPU 1939219015479 0819/0011548     ,0.00,1500000,9246436257.29,19080900115480000008,
777,09/08/2019,09:50:11,09/08/2019,09:50:11,0247 UKT 1939219015479 0819/0011548     ,0.00,5600000,9252036257.29,19080900115480000010,
778,09/08/2019,09:51:02,09/08/2019,09:51:02,0247 UKT 1939219014202 0819/0016999     ,0.00,1000000,9253036257.29,19080900169990000056,
779,09/08/2019,09:51:39,09/08/2019,09:51:39,0247 UKT 1939219014112 0819/0008188     ,0.00,4000000,9257036257.29,19080900081880000034,
780,09/08/2019,09:52:38,09/08/2019,09:52:38,0247 UKT 1939219014195 0819/0009627     ,0.00,1000000,9258036257.29,19080900096270000016,
781,09/08/2019,09:53:03,09/08/2019,09:53:03,0247 UKT 1939219004524 0819/0017966     ,0.00,5300000,9263336257.29,19080900179660000047,
782,09/08/2019,09:53:54,09/08/2019,09:53:54,0247 UKT 1939119002270 0819/0012474     ,0.00,4150000,9267486257.29,19080900124740000066,
783,09/08/2019,09:55:42,09/08/2019,09:55:42,0247 UKT 1939219007199 0819/0013447     ,0.00,5300000,9272786257.29,19080900134470000015,
784,09/08/2019,09:55:55,09/08/2019,09:55:55,0247 UKT 1939219011848 0819/0018005     ,0.00,3700000,9276486257.29,19080900180050000018,
785,09/08/2019,09:56:03,09/08/2019,09:56:03,0247 UKT 1939219007599 0819/0009659     ,0.00,3000000,9279486257.29,19080900096590000022,
786,09/08/2019,09:56:22,09/08/2019,09:56:22,0247 SPU 1939219007599 0819/0009659     ,0.00,750000,9280236257.29,19080900096590000024,
787,09/08/2019,09:56:37,09/08/2019,09:56:37,0247 UKT 1939219001147 0819/0008219     ,0.00,5300000,9285536257.29,19080900082190000079,
788,09/08/2019,09:57:45,09/08/2019,09:57:45,0247 UKT 1801617047 0819/0016541        ,0.00,4000000,9289536257.29,19080900165410000033,
789,09/08/2019,09:57:59,09/08/2019,09:57:59,0247 UKT 1939219002873 0819/0008219     ,0.00,6700000,9296236257.29,19080900082190000081,
790,09/08/2019,09:58:07,09/08/2019,09:58:07,0247 UKT 1939219015004 0819/0008558     ,0.00,3000000,9299236257.29,19080900085580000002,
791,09/08/2019,09:58:41,09/08/2019,09:58:41,0247 SPU 1939219011848 0819/0018005     ,0.00,2000000,9301236257.29,19080900180050000021,
792,09/08/2019,09:59:27,09/08/2019,09:59:27,0247 UKT 1107617229 0819/0016660        ,0.00,3000000,9304236257.29,19080900166600000021,
793,09/08/2019,10:00:12,09/08/2019,10:00:12,0247 UKT 1939219000599 0819/0008219     ,0.00,5100000,9309336257.29,19080900082190000083,
794,09/08/2019,10:00:31,09/08/2019,10:00:31,0247 UKT 1939219009241 0819/0012923     ,0.00,3000000,9312336257.29,19080900129230000104,
795,09/08/2019,10:01:49,09/08/2019,10:01:49,0247 UKT 1939219007605 0819/0008219     ,0.00,1000000,9313336257.29,19080900082190000085,
796,09/08/2019,10:04:15,09/08/2019,10:04:15,0247 UKT 1939219003220 0819/0008219     ,0.00,5100000,9318436257.29,19080900082190000087,
797,09/08/2019,10:04:33,09/08/2019,10:04:33,0247 SPU 1939219003220 0819/0008219     ,0.00,1500000,9319936257.29,19080900082190000089,
798,09/08/2019,10:04:35,09/08/2019,10:04:35,0247 UKT 1939119001632 0819/0008594     ,0.00,5200000,9325136257.29,19080900085940000012,
799,09/08/2019,10:05:20,09/08/2019,10:05:20,0247 UKT 1939219008043 0819/0016991     ,0.00,5100000,9330236257.29,19080900169910000019,
800,09/08/2019,10:05:29,09/08/2019,10:05:29,0247 UKT 1939219002308 0819/0016716     ,0.00,4700000,9334936257.29,19080900167160000016,
801,09/08/2019,10:06:24,09/08/2019,10:06:24,0247 SPU 1939119001632 0819/0008594     ,0.00,15000000,9349936257.29,19080900085940000014,
802,09/08/2019,10:06:30,09/08/2019,10:06:30,0247 SPU 1939219002308 0819/0016716     ,0.00,750000,9350686257.29,19080900167160000018,
803,09/08/2019,10:06:57,09/08/2019,10:06:57,0247 UKT 1939119001587 0819/0013175     ,0.00,6200000,9356886257.29,19080900131750000091,
804,09/08/2019,10:07:31,09/08/2019,10:07:31,0247 UKT 1939219004014 0819/0008219     ,0.00,5900000,9362786257.29,19080900082190000091,
805,09/08/2019,10:08:20,09/08/2019,10:08:20,0247 UKT 1801617171 0819/0007348        ,0.00,4000000,9366786257.29,19080900073480000075,
806,09/08/2019,10:08:24,09/08/2019,10:08:24,0247 UKT 1939319000701 0819/0011548     ,0.00,3000000,9369786257.29,19080900115480000015,
807,09/08/2019,10:09:14,09/08/2019,10:09:14,0247 SPU 1939219008043 0819/0016991     ,0.00,1000000,9370786257.29,19080900169910000021,
808,09/08/2019,10:09:53,09/08/2019,10:09:53,0247 UKT 1939219001015 0819/0008219     ,0.00,5300000,9376086257.29,19080900082190000093,
809,09/08/2019,10:09:56,09/08/2019,10:09:56,0247 UKT 1939219010555 0819/0012476     ,0.00,5600000,9381686257.29,19080900124760000046,
810,09/08/2019,10:10:09,09/08/2019,10:10:09,0247 SPU 1939219001015 0819/0008219     ,0.00,3000000,9384686257.29,19080900082190000095,
811,09/08/2019,10:10:16,09/08/2019,10:10:16,0247 UKT 1939119000097 0819/0007348     ,0.00,6200000,9390886257.29,19080900073480000077,
812,09/08/2019,10:10:21,09/08/2019,10:10:21,0247 SPU 1939219010555 0819/0012476     ,0.00,5000000,9395886257.29,19080900124760000048,
813,09/08/2019,10:10:28,09/08/2019,10:10:28,0247 UKT 1939319000740 0819/0016441     ,0.00,5100000,9400986257.29,19080900164410000073,
814,09/08/2019,10:10:39,09/08/2019,10:10:39,0247 UKT 1939319000631 0819/0006645     ,0.00,6500000,9407486257.29,19080900066450000094,
815,09/08/2019,10:11:01,09/08/2019,10:11:01,0247 UKT 1939219000620 0819/0018139     ,0.00,3900000,9411386257.29,19080900181390000020,
816,09/08/2019,10:11:32,09/08/2019,10:11:32,0247 UKT 1939119002048 0819/0018029     ,0.00,5200000,9416586257.29,19080900180290000157,
817,09/08/2019,10:11:42,09/08/2019,10:11:42,0247 UKT 1939219010232 0819/0008219     ,0.00,3000000,9419586257.29,19080900082190000097,
818,09/08/2019,10:11:47,09/08/2019,10:11:47,0247 SPU 1939219002141 0819/0016990     ,0.00,1000000,9420586257.29,19080900169900000030,
819,09/08/2019,10:11:55,09/08/2019,10:11:55,0247 UKT 1107617059 0819/0011952        ,0.00,6400000,9426986257.29,19080900119520000046,
820,09/08/2019,10:11:57,09/08/2019,10:11:57,0247 SPU 1939219012850 0819/0010977     ,0.00,2000000,9428986257.29,19080900109770000033,
821,09/08/2019,10:12:12,09/08/2019,10:12:12,0247 UKT 1939219002141 0819/0016990     ,0.00,1000000,9429986257.29,19080900169900000032,
822,09/08/2019,10:12:34,09/08/2019,10:12:34,0247 UKT 1939219012850 0819/0010977     ,0.00,6100000,9436086257.29,19080900109770000035,
823,09/08/2019,10:13:18,09/08/2019,10:13:18,0247 UKT 1939219007670 0819/0011932     ,0.00,7400000,9443486257.29,19080900119320000014,
824,09/08/2019,10:13:26,09/08/2019,10:13:26,0247 UKT 1939219000845 0819/0008219     ,0.00,6400000,9449886257.29,19080900082190000099,
825,09/08/2019,10:13:37,09/08/2019,10:13:37,0247 UKT 1939319000113 0819/0013051     ,0.00,6500000,9456386257.29,19080900130510000042,
826,09/08/2019,10:13:48,09/08/2019,10:13:48,0247 UKT 1939119000915 0819/0007348     ,0.00,3950000,9460336257.29,19080900073480000081,
827,09/08/2019,10:14:49,09/08/2019,10:14:49,0247 UKT 1939119002995 0819/0011952     ,0.00,4000000,9464336257.29,19080900119520000048,
828,09/08/2019,10:14:52,09/08/2019,10:14:52,0247 UKT 1939219012117 0819/0018013     ,0.00,4600000,9468936257.29,19080900180130000015,
829,09/08/2019,10:15:02,09/08/2019,10:15:02,0247 UKT 1308617008 0819/0007012        ,0.00,4150000,9473086257.29,19080900070120000101,
830,09/08/2019,10:15:15,09/08/2019,10:15:15,0247 SPU 1939119002995 0819/0011952     ,0.00,2000000,9475086257.29,19080900119520000050,
831,09/08/2019,10:15:21,09/08/2019,10:15:21,0247 UKT 1939219016349 0819/0007348     ,0.00,500000,9475586257.29,19080900073480000083,
832,09/08/2019,10:15:43,09/08/2019,10:15:43,0247 UKT 1939119002034 0819/0008219     ,0.00,4150000,9479736257.29,19080900082190000101,
833,09/08/2019,10:16:02,09/08/2019,10:16:02,0247 SPU 1939119002034 0819/0008219     ,0.00,5000000,9484736257.29,19080900082190000103,
834,09/08/2019,10:16:26,09/08/2019,10:16:26,0247 UKT 1939119000459 0819/0012490     ,0.00,500000,9485236257.29,19080900124900000030,
835,09/08/2019,10:17:25,09/08/2019,10:17:25,0247 UKT 1103618056 0819/0018007        ,0.00,5300000,9490536257.29,19080900180070000013,
836,09/08/2019,10:17:34,09/08/2019,10:17:34,0247 UKT 1939219002334 0819/0008219     ,0.00,5100000,9495636257.29,19080900082190000105,
837,09/08/2019,10:17:36,09/08/2019,10:17:36,0247 SPU 1939219007670 0819/0011932     ,0.00,2500000,9498136257.29,19080900119320000016,
838,09/08/2019,10:17:50,09/08/2019,10:17:50,0247 SPU 1939219002334 0819/0008219     ,0.00,10000000,9508136257.29,19080900082190000107,
839,09/08/2019,10:18:15,09/08/2019,10:18:15,0247 UKT 1939119002713 0819/0010458     ,0.00,3950000,9512086257.29,19080900104580000048,
840,09/08/2019,10:18:51,09/08/2019,10:18:51,0247 UKT 1939219000622 0819/0010977     ,0.00,8200000,9520286257.29,19080900109770000037,
841,09/08/2019,10:19:16,09/08/2019,10:19:16,0247 SPU 1939219000622 0819/0010977     ,0.00,750000,9521036257.29,19080900109770000039,
842,09/08/2019,10:19:26,09/08/2019,10:19:26,0247 SPU 1939219008664 0819/0007901     ,0.00,1000000,9522036257.29,19080900079010000023,
843,09/08/2019,10:19:28,09/08/2019,10:19:28,0247 UKT 1107618018 0819/0017359        ,0.00,3000000,9525036257.29,19080900173590000010,
844,09/08/2019,10:19:47,09/08/2019,10:19:47,0247 SPU 1939119002713 0819/0010458     ,0.00,1000000,9526036257.29,19080900104580000050,
845,09/08/2019,10:19:47,09/08/2019,10:19:47,0247 UKT 1939219008664 0819/0007901     ,0.00,4000000,9530036257.29,19080900079010000025,
846,09/08/2019,10:19:49,09/08/2019,10:19:49,0247 UKT 1939219007575 0819/0017008     ,0.00,3900000,9533936257.29,19080900170080000050,
847,09/08/2019,10:19:54,09/08/2019,10:19:54,0247 SPU 1939219000767 0819/0005992     ,0.00,3500000,9537436257.29,19080900059920000017,
848,09/08/2019,10:19:59,09/08/2019,10:19:59,0247 UKT 1939119002193 0819/0008219     ,0.00,1000000,9538436257.29,19080900082190000109,
849,09/08/2019,10:20:15,09/08/2019,10:20:15,0247 SPU 1939119002193 0819/0008219     ,0.00,750000,9539186257.29,19080900082190000111,
850,09/08/2019,10:20:30,09/08/2019,10:20:30,0247 UKT 1939219006270 0819/0008163     ,0.00,1000000,9540186257.29,19080900081630000088,
851,09/08/2019,10:20:32,09/08/2019,10:20:32,0247 SPU 1939219007575 0819/0017008     ,0.00,750000,9540936257.29,19080900170080000052,
852,09/08/2019,10:20:52,09/08/2019,10:20:52,0247 UKT 1939219008184 0819/0017789     ,0.00,5100000,9546036257.29,19080900177890000038,
853,09/08/2019,10:21:01,09/08/2019,10:21:01,0247 UKT 1939219000767 0819/0005992     ,0.00,6700000,9552736257.29,19080900059920000019,
854,09/08/2019,10:21:23,09/08/2019,10:21:23,0247 UKT 1304617045 0819/0008219        ,0.00,3950000,9556686257.29,19080900082190000113,
855,09/08/2019,10:21:32,09/08/2019,10:21:32,0247 SPU 1939119002257 0819/0007901     ,0.00,1000000,9557686257.29,19080900079010000027,
856,09/08/2019,10:21:56,09/08/2019,10:21:56,0247 UKT 1939119002257 0819/0007901     ,0.00,5200000,9562886257.29,19080900079010000029,
857,09/08/2019,10:22:39,09/08/2019,10:22:39,0247 UKT 1939219008841 0819/0012936     ,0.00,5300000,9568186257.29,19080900129360000024,
858,09/08/2019,10:23:02,09/08/2019,10:23:02,0247 UKT 1939119001757 0819/0016715     ,0.00,3800000,9571986257.29,19080900167150000014,
859,09/08/2019,10:23:16,09/08/2019,10:23:16,0247 UKT 1939219009343 0819/0013087     ,0.00,4300000,9576286257.29,19080900130870000032,
860,09/08/2019,10:23:54,09/08/2019,10:23:54,0247 UKT 1939119000062 0819/0008219     ,0.00,7300000,9583586257.29,19080900082190000115,
861,09/08/2019,10:24:10,09/08/2019,10:24:10,0247 SPU 1939119000062 0819/0008219     ,0.00,750000,9584336257.29,19080900082190000117,
862,09/08/2019,10:25:00,09/08/2019,10:25:00,0247 SPU 1939219008841 0819/0012936     ,0.00,20000000,9604336257.29,19080900129360000027,
863,09/08/2019,10:25:09,09/08/2019,10:25:09,0247 UKT 1939119001716 0819/0018027     ,0.00,3200000,9607536257.29,19080900180270000024,
864,09/08/2019,10:25:20,09/08/2019,10:25:20,0247 UKT 1939219002758 0819/0010960     ,0.00,5100000,9612636257.29,19080900109600000021,
865,09/08/2019,10:25:38,09/08/2019,10:25:38,0247 SPU 1939219003813 0819/0013502     ,0.00,3500000,9616136257.29,19080900135020000022,
866,09/08/2019,10:25:53,09/08/2019,10:25:53,0247 UKT 1939219006092 0819/0013055     ,0.00,5800000,9621936257.29,19080900130550000103,
867,09/08/2019,10:25:56,09/08/2019,10:25:56,0247 SPU 1939119001716 0819/0018027     ,0.00,2000000,9623936257.29,19080900180270000026,
868,09/08/2019,10:26:11,09/08/2019,10:26:11,0247 UKT 1939219003813 0819/0013502     ,0.00,4000000,9627936257.29,19080900135020000024,
869,09/08/2019,10:26:50,09/08/2019,10:26:50,0247 UKT 1801617012 0819/0017472        ,0.00,4000000,9631936257.29,19080900174720000045,
870,09/08/2019,10:27:11,09/08/2019,10:27:11,0247 UKT 1939219005292 0819/0008219     ,0.00,5600000,9637536257.29,19080900082190000119,
871,09/08/2019,10:27:29,09/08/2019,10:27:29,0247 SPU 1939219005292 0819/0008219     ,0.00,1000000,9638536257.29,19080900082190000121,
872,09/08/2019,10:28:01,09/08/2019,10:28:01,0247 UKT 1210618072 0819/0013482        ,0.00,4600000,9643136257.29,19080900134820000097,
873,09/08/2019,10:28:08,09/08/2019,10:28:08,0247 UKT 1939119001109 0819/0010956     ,0.00,3200000,9646336257.29,19080900109560000101,
874,09/08/2019,10:29:17,09/08/2019,10:29:17,0247 UKT 1939219003594 0819/0008555     ,0.00,3900000,9650236257.29,19080900085550000021,
875,09/08/2019,10:29:17,09/08/2019,10:29:17,0247 UKT 1939119001907 0819/0008219     ,0.00,4300000,9654536257.29,19080900082190000123,
876,09/08/2019,10:29:30,09/08/2019,10:29:30,0247 UKT 1939219014773 0819/0013182     ,0.00,5100000,9659636257.29,19080900131820000036,
877,09/08/2019,10:30:00,09/08/2019,10:30:00,0247 SPU 1939219014773 0819/0013182     ,0.00,750000,9660386257.29,19080900131820000039,
878,09/08/2019,10:30:35,09/08/2019,10:30:35,0247 UKT 1308618007 0819/0007348        ,0.00,4150000,9664536257.29,19080900073480000085,
879,09/08/2019,10:30:53,09/08/2019,10:30:53,0247 UKT 1939219007846 0819/0012248     ,0.00,5100000,9669636257.29,19080900122480000074,
880,09/08/2019,10:31:13,09/08/2019,10:31:13,0247 SPU 1939219007846 0819/0012248     ,0.00,1000000,9670636257.29,19080900122480000076,
881,09/08/2019,10:31:53,09/08/2019,10:31:53,0247 SPU 1939119002772 0819/0013062     ,0.00,5000000,9675636257.29,19080900130620000057,
882,09/08/2019,10:32:06,09/08/2019,10:32:06,0247 UKT 1939119003926 0819/0013056     ,0.00,6250000,9681886257.29,19080900130560000026,
883,09/08/2019,10:32:08,09/08/2019,10:32:08,0247 UKT 1939219015147 0819/0012476     ,0.00,4300000,9686186257.29,19080900124760000054,
884,09/08/2019,10:32:24,09/08/2019,10:32:24,0247 UKT 1939119002772 0819/0013062     ,0.00,4500000,9690686257.29,19080900130620000059,
885,09/08/2019,10:32:56,09/08/2019,10:32:56,0247 UKT 1302617039 0819/0008219        ,0.00,6000000,9696686257.29,19080900082190000125,
886,09/08/2019,10:33:27,09/08/2019,10:33:27,0247 UKT 1204618020 0819/0009628        ,0.00,1000000,9697686257.29,19080900096280000006,
887,09/08/2019,10:33:29,09/08/2019,10:33:29,0247 UKT 1939119001628 0819/0010458     ,0.00,3950000,9701636257.29,19080900104580000052,
888,09/08/2019,10:33:30,09/08/2019,10:33:30,0247 UKT 1939219005137 0819/0009612     ,0.00,1000000,9702636257.29,19080900096120000031,
889,09/08/2019,10:34:02,09/08/2019,10:34:02,0247 UKT 1801617166 0819/0008219        ,0.00,4000000,9706636257.29,19080900082190000127,
890,09/08/2019,10:34:10,09/08/2019,10:34:10,0247 UKT 1939119003731 0819/0008220     ,0.00,3950000,9710586257.29,19080900082200000008,
891,09/08/2019,10:34:29,09/08/2019,10:34:29,0247 UKT 1106618034 0819/0008572        ,0.00,4500000,9715086257.29,19080900085720000089,
892,09/08/2019,10:35:06,09/08/2019,10:35:06,0247 UKT 1939119003426 0819/0016993     ,0.00,3800000,9718886257.29,19080900169930000041,
893,09/08/2019,10:36:08,09/08/2019,10:36:08,0247 UKT 1939219014571 0819/0006669     ,0.00,3000000,9721886257.29,19080900066690000030,
894,09/08/2019,10:36:14,09/08/2019,10:36:14,0247 UKT 1301617060 0819/0016661        ,0.00,6000000,9727886257.29,19080900166610000071,
895,09/08/2019,10:36:26,09/08/2019,10:36:26,0247 UKT 1939219008454 0819/0013788     ,0.00,1000000,9728886257.29,19080900137880000029,
896,09/08/2019,10:36:42,09/08/2019,10:36:42,0247 UKT 1939219009074 0819/0008219     ,0.00,8200000,9737086257.29,19080900082190000129,
897,09/08/2019,10:36:55,09/08/2019,10:36:55,0247 SPU 1939219009074 0819/0008219     ,0.00,750000,9737836257.29,19080900082190000131,
898,09/08/2019,10:38:01,09/08/2019,10:38:01,0247 UKT 1939119001886 0819/0017472     ,0.00,6200000,9744036257.29,19080900174720000055,
899,09/08/2019,10:38:15,09/08/2019,10:38:15,0247 UKT 1939219003565 0819/0013762     ,0.00,8200000,9752236257.29,19080900137620000050,
900,09/08/2019,10:38:28,09/08/2019,10:38:28,0247 UKT 1939219008196 0819/0009558     ,0.00,2700000,9754936257.29,19080900095580000025,
901,09/08/2019,10:39:03,09/08/2019,10:39:03,0247 SPU 1939119001886 0819/0017472     ,0.00,750000,9755686257.29,19080900174720000057,
902,09/08/2019,10:39:26,09/08/2019,10:39:26,0247 UKT 1939219003178 0819/0007348     ,0.00,4700000,9760386257.29,19080900073480000091,
903,09/08/2019,10:39:32,09/08/2019,10:39:32,0247 SPU 1939219016474 0819/0017012     ,0.00,750000,9761136257.29,19080900170120000038,
904,09/08/2019,10:39:48,09/08/2019,10:39:48,0247 UKT 1939219001369 0819/0011932     ,0.00,1000000,9762136257.29,19080900119320000020,
905,09/08/2019,10:39:50,09/08/2019,10:39:50,0247 UKT 1939219007476 0819/0013765     ,0.00,6200000,9768336257.29,19080900137650000042,
906,09/08/2019,10:40:04,09/08/2019,10:40:04,0247 UKT 1939219016474 0819/0017012     ,0.00,6700000,9775036257.29,19080900170120000040,
907,09/08/2019,10:40:06,09/08/2019,10:40:06,0247 SPU 1939219003565 0819/0013762     ,0.00,5000000,9780036257.29,19080900137620000052,
908,09/08/2019,10:40:09,09/08/2019,10:40:09,0247 UKT 1939219007525 0819/0008219     ,0.00,7400000,9787436257.29,19080900082190000133,
909,09/08/2019,10:40:20,09/08/2019,10:40:20,0247 UKT 1939119000507 0819/0009627     ,0.00,3800000,9791236257.29,19080900096270000027,
910,09/08/2019,10:40:26,09/08/2019,10:40:26,0247 SPU 1939219007525 0819/0008219     ,0.00,10000000,9801236257.29,19080900082190000135,
911,09/08/2019,10:40:49,09/08/2019,10:40:49,0247 UKT 1939119002164 0819/0010960     ,0.00,1000000,9802236257.29,19080900109600000023,
912,09/08/2019,10:43:10,09/08/2019,10:43:10,0247 UKT 1602618031 0819/0006459        ,0.00,2700000,9804936257.29,19080900064590000021,
913,09/08/2019,10:43:20,09/08/2019,10:43:20,0247 UKT 1939119001671 0819/0016993     ,0.00,3800000,9808736257.29,19080900169930000043,
914,09/08/2019,10:43:21,09/08/2019,10:43:21,0247 SPU 1939219010211 0819/0016487     ,0.00,750000,9809486257.29,19080900164870000029,
915,09/08/2019,10:43:42,09/08/2019,10:43:42,0247 UKT 1939219010211 0819/0016487     ,0.00,3000000,9812486257.29,19080900164870000031,
916,09/08/2019,10:44:27,09/08/2019,10:44:27,0247 UKT 1939219003475 0819/0016631     ,0.00,6472000,9818958257.29,19080900166310000015,
917,09/08/2019,10:44:30,09/08/2019,10:44:30,0247 UKT 1213617017 0819/0009748        ,0.00,1000000,9819958257.29,19080900097480000013,
918,09/08/2019,10:45:05,09/08/2019,10:45:05,0247 SPU 1939219003475 0819/0016631     ,0.00,3500000,9823458257.29,19080900166310000017,
919,09/08/2019,10:46:39,09/08/2019,10:46:39,0247 UKT 1939219000267 0819/0016716     ,0.00,4500000,9827958257.29,19080900167160000024,
920,09/08/2019,10:46:47,09/08/2019,10:46:47,0247 UKT 1801618144 0819/0008219        ,0.00,10300000,9838258257.29,19080900082190000141,
921,09/08/2019,10:47:29,09/08/2019,10:47:29,0247 UKT 1939219015845 0819/0016619     ,0.00,5700000,9843958257.29,19080900166190000053,
922,09/08/2019,10:48:09,09/08/2019,10:48:09,0247 UKT 1939319000437 0819/0017017     ,0.00,3000000,9846958257.29,19080900170170000058,
923,09/08/2019,10:48:10,09/08/2019,10:48:10,0247 UKT 1305617037 0819/0008219        ,0.00,6200000,9853158257.29,19080900082190000143,
924,09/08/2019,10:48:16,09/08/2019,10:48:16,0247 SPU 1939219015845 0819/0016619     ,0.00,5000000,9858158257.29,19080900166190000056,
925,09/08/2019,10:48:16,09/08/2019,10:48:16,0247 UKT 1939219011830 0819/0006338     ,0.00,5100000,9863258257.29,19080900063380000157,
926,09/08/2019,10:49:09,09/08/2019,10:49:09,0247 UKT 1939219012833 0819/0016441     ,0.00,5900000,9869158257.29,19080900164410000090,
927,09/08/2019,10:49:30,09/08/2019,10:49:30,0247 UKT 1939219010186 0819/0013439     ,0.00,6400000,9875558257.29,19080900134390000037,
928,09/08/2019,10:49:55,09/08/2019,10:49:55,0247 UKT 1939219008662 0819/0008219     ,0.00,4500000,9880058257.29,19080900082190000145,
929,09/08/2019,10:51:01,09/08/2019,10:51:01,0247 UKT 1939219013344 0819/0016661     ,0.00,2700000,9882758257.29,19080900166610000077,
930,09/08/2019,10:51:23,09/08/2019,10:51:23,0247 UKT 1307617022 0819/0011952        ,0.00,5250000,9888008257.29,19080900119520000066,
931,09/08/2019,10:51:29,09/08/2019,10:51:29,0247 UKT 1939219016176 0819/0013066     ,0.00,4300000,9892308257.29,19080900130660000033,
932,09/08/2019,10:51:48,09/08/2019,10:51:48,0247 SPU 1939219008196 0819/0009558     ,0.00,750000,9893058257.29,19080900095580000032,
933,09/08/2019,10:52:06,09/08/2019,10:52:06,0247 UKT 1105618010 0819/0016441        ,0.00,1000000,9894058257.29,19080900164410000094,
934,09/08/2019,10:52:16,09/08/2019,10:52:16,0247 UKT 1939119001673 0819/0008219     ,0.00,1000000,9895058257.29,19080900082190000147,
935,09/08/2019,10:52:32,09/08/2019,10:52:32,0247 SPU 1939119001673 0819/0008219     ,0.00,750000,9895808257.29,19080900082190000149,
936,09/08/2019,10:52:46,09/08/2019,10:52:46,0247 UKT 1939219006338 0819/0017974     ,0.00,6900000,9902708257.29,19080900179740000101,
937,09/08/2019,10:53:02,09/08/2019,10:53:02,0247 UKT 1939219004215 0819/0008561     ,0.00,9300000,9912008257.29,19080900085610000025,
938,09/08/2019,10:53:11,09/08/2019,10:53:11,0247 UKT 1801617207 0819/0016999        ,0.00,6200000,9918208257.29,19080900169990000074,
939,09/08/2019,10:53:33,09/08/2019,10:53:33,0247 UKT 1939219008525 0819/0018138     ,0.00,4000000,9922208257.29,19080900181380000039,
940,09/08/2019,10:54:12,09/08/2019,10:54:12,0247 UKT 1939219013442 0819/0008219     ,0.00,5300000,9927508257.29,19080900082190000151,
941,09/08/2019,10:54:20,09/08/2019,10:54:20,0247 UKT 1939219007665 0819/0017989     ,0.00,3900000,9931408257.29,19080900179890000057,
942,09/08/2019,10:55:52,09/08/2019,10:55:52,0247 UKT 1939219006336 0819/0008219     ,0.00,3000000,9934408257.29,19080900082190000153,
943,09/08/2019,10:56:20,09/08/2019,10:56:20,0247 SPU 1939219007665 0819/0017989     ,0.00,3000000,9937408257.29,19080900179890000060,
944,09/08/2019,10:56:40,09/08/2019,10:56:40,0247 UKT 1939219003902 0819/0016657     ,0.00,5100000,9942508257.29,19080900166570000055,
945,09/08/2019,10:57:05,09/08/2019,10:57:05,0247 UKT 1939219002611 0819/0008219     ,0.00,3000000,9945508257.29,19080900082190000155,
946,09/08/2019,10:57:25,09/08/2019,10:57:25,0247 SPU 1939219005809 0819/0013436     ,0.00,750000,9946258257.29,19080900134360000088,
947,09/08/2019,10:58:02,09/08/2019,10:58:02,0247 UKT 1939219000527 0819/0008219     ,0.00,1000000,9947258257.29,19080900082190000157,
948,09/08/2019,10:58:05,09/08/2019,10:58:05,0247 SPU 1939219015502 0819/0017017     ,0.00,1500000,9948758257.29,19080900170170000061,
949,09/08/2019,10:58:07,09/08/2019,10:58:07,0247 UKT 1939219005809 0819/0013436     ,0.00,3400000,9952158257.29,19080900134360000090,
950,09/08/2019,10:58:08,09/08/2019,10:58:08,0247 SPU 1939219015122 0819/0008574     ,0.00,750000,9952908257.29,19080900085740000087,
951,09/08/2019,10:58:23,09/08/2019,10:58:23,0247 UKT 1939219002638 0819/0016660     ,0.00,5300000,9958208257.29,19080900166600000045,
952,09/08/2019,10:58:33,09/08/2019,10:58:33,0247 UKT 1939219015502 0819/0017017     ,0.00,5100000,9963308257.29,19080900170170000063,
953,09/08/2019,10:58:37,09/08/2019,10:58:37,0247 UKT 1939219015122 0819/0008574     ,0.00,4500000,9967808257.29,19080900085740000089,
954,09/08/2019,10:58:56,09/08/2019,10:58:56,0247 UKT 1602617033 0819/0008219        ,0.00,2700000,9970508257.29,19080900082190000159,
955,09/08/2019,10:58:57,09/08/2019,10:58:57,0247 UKT 1106618006 0819/0013487        ,0.00,3000000,9973508257.29,19080900134870000045,
956,09/08/2019,10:58:58,09/08/2019,10:58:58,0247 UKT 1601618074 0819/0016688        ,0.00,3400000,9976908257.29,19080900166880000054,
957,09/08/2019,10:59:08,09/08/2019,10:59:08,0247 UKT 1210617027 0819/0013823        ,0.00,1000000,9977908257.29,19080900138230000129,
958,09/08/2019,10:59:21,09/08/2019,10:59:21,0247 UKT 1939219009140 0819/0011829     ,0.00,3000000,9980908257.29,19080900118290000060,
959,09/08/2019,10:59:43,09/08/2019,10:59:43,0247 SPU 1939219009140 0819/0011829     ,0.00,750000,9981658257.29,19080900118290000062,
960,09/08/2019,11:00:03,09/08/2019,11:00:03,0247 UKT 1939319000651 0819/0018000     ,0.00,3000000,9984658257.29,19080900180000000019,
961,09/08/2019,11:00:05,09/08/2019,11:00:05,0247 UKT 1939319000123 0819/0012246     ,0.00,500000,9985158257.29,19080900122460000036,
962,09/08/2019,11:00:07,09/08/2019,11:00:07,0247 UKT 1302617017 0819/0008246        ,0.00,4300000,9989458257.29,19080900082460000073,
963,09/08/2019,11:00:24,09/08/2019,11:00:24,0247 UKT 1303617006 0819/0007348        ,0.00,3950000,9993408257.29,19080900073480000109,
964,09/08/2019,11:00:29,09/08/2019,11:00:29,0247 UKT 1939119001125 0819/0016545     ,0.00,500000,9993908257.29,19080900165450000121,
965,09/08/2019,11:01:00,09/08/2019,11:01:00,0247 UKT 1939219001400 0819/0017015     ,0.00,5100000,9999008257.29,19080900170150000056,
966,09/08/2019,11:01:28,09/08/2019,11:01:28,0247 UKT 1303617055 0819/0008219        ,0.00,6200000,10005208257.29,19080900082190000161,
967,09/08/2019,11:01:58,09/08/2019,11:01:58,0247 UKT 1939219003372 0819/0008251     ,0.00,4000000,10009208257.29,19080900082510000063,
968,09/08/2019,11:02:55,09/08/2019,11:02:55,0247 UKT 1801617300 0819/0007367        ,0.00,8200000,10017408257.29,19080900073670000031,
969,09/08/2019,11:03:19,09/08/2019,11:03:19,0247 UKT 1939219005521 0819/0016660     ,0.00,6000000,10023408257.29,19080900166600000047,
970,09/08/2019,11:03:22,09/08/2019,11:03:22,0247 UKT 1939219006064 0819/0016439     ,0.00,2700000,10026108257.29,19080900164390000029,
971,09/08/2019,11:03:41,09/08/2019,11:03:41,0247 UKT 1939119001809 0819/0008219     ,0.00,3950000,10030058257.29,19080900082190000163,
972,09/08/2019,11:04:04,09/08/2019,11:04:04,0247 SPU 1939119001809 0819/0008219     ,0.00,750000,10030808257.29,19080900082190000165,
973,09/08/2019,11:05:45,09/08/2019,11:05:45,0247 UKT 1210617010 0819/0012239        ,0.00,4600000,10035408257.29,19080900122390000031,
974,09/08/2019,11:06:09,09/08/2019,11:06:09,0247 UKT 1939219000603 0819/0013056     ,0.00,6500000,10041908257.29,19080900130560000048,
975,09/08/2019,11:06:09,09/08/2019,11:06:09,0247 UKT 1939219001352 0819/0008555     ,0.00,8200000,10050108257.29,19080900085550000023,
976,09/08/2019,11:06:12,09/08/2019,11:06:12,0247 UKT 1939119000682 0819/0017008     ,0.00,6250000,10056358257.29,19080900170080000069,
977,09/08/2019,11:06:17,09/08/2019,11:06:17,0247 SPU 1939119003075 0819/0008219     ,0.00,2000000,10058358257.29,19080900082190000167,
978,09/08/2019,11:06:36,09/08/2019,11:06:36,0247 SPU 1939219000603 0819/0013056     ,0.00,1000000,10059358257.29,19080900130560000050,
979,09/08/2019,11:06:37,09/08/2019,11:06:37,0247 UKT 1939219001999 0819/0018000     ,0.00,3000000,10062358257.29,19080900180000000021,
980,09/08/2019,11:07:20,09/08/2019,11:07:20,0247 SPU 1939219001999 0819/0018000     ,0.00,1000000,10063358257.29,19080900180000000023,
981,09/08/2019,11:07:46,09/08/2019,11:07:46,0247 SPU 1939119002439 0819/0008175     ,0.00,3000000,10066358257.29,19080900081750000014,
982,09/08/2019,11:08:12,09/08/2019,11:08:12,0247 UKT 1939119002439 0819/0008175     ,0.00,6200000,10072558257.29,19080900081750000016,
983,09/08/2019,11:08:37,09/08/2019,11:08:37,0247 SPU 1939219012461 0819/0008219     ,0.00,1000000,10073558257.29,19080900082190000169,
984,09/08/2019,11:12:31,09/08/2019,11:12:31,0247 UKT 1303617022 0819/0008219        ,0.00,3950000,10077508257.29,19080900082190000172,
985,09/08/2019,11:14:07,09/08/2019,11:14:07,0247 UKT 1939219006118 0819/0012490     ,0.00,3000000,10080508257.29,19080900124900000035,
986,09/08/2019,11:14:17,09/08/2019,11:14:17,0247 UKT 1939219004023 0819/0013447     ,0.00,3000000,10083508257.29,19080900134470000048,
987,09/08/2019,11:14:18,09/08/2019,11:14:18,0247 UKT 1939219010822 0819/0007348     ,0.00,500000,10084008257.29,19080900073480000118,
988,09/08/2019,11:14:19,09/08/2019,11:14:19,0247 UKT 1303617070 0819/0008219        ,0.00,3950000,10087958257.29,19080900082190000174,
989,09/08/2019,11:14:33,09/08/2019,11:14:33,0247 UKT 1939219009316 0819/0008175     ,0.00,8200000,10096158257.29,19080900081750000018,
990,09/08/2019,11:14:52,09/08/2019,11:14:52,0247 SPU 1939219004023 0819/0013447     ,0.00,750000,10096908257.29,19080900134470000050,
991,09/08/2019,11:15:11,09/08/2019,11:15:11,0247 SPU 1939219006118 0819/0012490     ,0.00,1000000,10097908257.29,19080900124900000037,
992,09/08/2019,11:17:20,09/08/2019,11:17:20,0247 UKT 1939219001590 0819/0016438     ,0.00,4700000,10102608257.29,19080900164380000051,
993,09/08/2019,11:17:25,09/08/2019,11:17:25,0247 UKT 1939219017182 0819/0011958     ,0.00,5100000,10107708257.29,19080900119580000135,
994,09/08/2019,11:17:56,09/08/2019,11:17:56,0247 SPU 1939219005005 0819/0008219     ,0.00,1000000,10108708257.29,19080900082190000178,
995,09/08/2019,11:20:22,09/08/2019,11:20:22,0247 UKT 1939219005334 0819/0007168     ,0.00,7700000,10116408257.29,19080900071680000191,
996,09/08/2019,11:21:43,09/08/2019,11:21:43,0247 UKT 1801617309 0819/0006459        ,0.00,8200000,10124608257.29,19080900064590000030,
997,09/08/2019,11:24:31,09/08/2019,11:24:31,0247 SPU 1939119001278 0819/0016491     ,0.00,1000000,10125608257.29,19080900164910000097,
998,09/08/2019,11:24:36,09/08/2019,11:24:36,0247 UKT 1939219008424 0819/0008941     ,0.00,6700000,10132308257.29,19080900089410000049,
999,09/08/2019,11:24:57,09/08/2019,11:24:57,0247 UKT 1939219003175 0819/0010462     ,0.00,6700000,10139008257.29,19080900104620000055,
1000,09/08/2019,11:25:17,09/08/2019,11:25:17,0247 UKT 1939319000334 0819/0008219     ,0.00,6200000,10145208257.29,19080900082190000180,
1001,09/08/2019,11:25:46,09/08/2019,11:25:46,0247 SPU 1939319000334 0819/0008219     ,0.00,10000000,10155208257.29,19080900082190000182,
1002,09/08/2019,11:27:44,09/08/2019,11:27:44,0247 UKT 1939219011930 0819/0008219     ,0.00,3000000,10158208257.29,19080900082190000184,
1003,09/08/2019,11:28:22,09/08/2019,11:28:22,0247 UKT 1208617053 0819/0007348        ,0.00,6700000,10164908257.29,19080900073480000122,
1004,09/08/2019,11:28:57,09/08/2019,11:28:57,0247 UKT 1939119000587 0819/0018018     ,0.00,6200000,10171108257.29,19080900180180000057,
1005,09/08/2019,11:30:27,09/08/2019,11:30:27,0247 UKT 1939119000595 0819/0009772     ,0.00,5400000,10176508257.29,19080900097720000083,
1006,09/08/2019,11:30:57,09/08/2019,11:30:57,0247 SPU 1939119000595 0819/0009772     ,0.00,1000000,10177508257.29,19080900097720000085,
1007,09/08/2019,11:31:46,09/08/2019,11:31:46,0247 UKT 1939219011013 0819/0007367     ,0.00,1000000,10178508257.29,19080900073670000034,
1008,09/08/2019,11:32:07,09/08/2019,11:32:07,0247 SPU 1939219011013 0819/0007367     ,0.00,2000000,10180508257.29,19080900073670000036,
1009,09/08/2019,11:32:09,09/08/2019,11:32:09,0247 UKT 1939119000970 0819/0013051     ,0.00,4300000,10184808257.29,19080900130510000085,
1010,09/08/2019,11:35:41,09/08/2019,11:35:41,0247 UKT 1939319000442 0819/0017008     ,0.00,3000000,10187808257.29,19080900170080000087,
1011,09/08/2019,11:40:53,09/08/2019,11:40:53,0247 UKT 1304618015 0819/0013067        ,0.00,6200000,10194008257.29,19080900130670000027,
1012,09/08/2019,11:43:17,09/08/2019,11:43:17,0247 UKT 1939119003131 0819/0012236     ,0.00,1000000,10195008257.29,19080900122360000013,
1013,09/08/2019,11:46:36,09/08/2019,11:46:36,0247 UKT 1939319000228 0819/0016438     ,0.00,4300000,10199308257.29,19080900164380000059,
1014,09/08/2019,11:47:46,09/08/2019,11:47:46,0247 SPU 1939319000228 0819/0016438     ,0.00,1000000,10200308257.29,19080900164380000061,
1015,09/08/2019,11:52:15,09/08/2019,11:52:15,0247 UKT 1939219010820 0819/0011939     ,0.00,3900000,10204208257.29,19080900119390000018,
1016,09/08/2019,12:19:25,09/08/2019,12:19:25,0247 UKT 1939219011552 0819/0012249     ,0.00,1000000,10205208257.29,19080900122490000038,
1017,09/08/2019,12:32:55,09/08/2019,12:32:55,0247 UKT 1939219012985 0819/0010977     ,0.00,1000000,10206208257.29,19080900109770000061,
1018,09/08/2019,12:33:38,09/08/2019,12:33:38,0247 UKT 1939219008907 0819/0011932     ,0.00,6700000,10212908257.29,19080900119320000028,
1019,09/08/2019,12:39:19,09/08/2019,12:39:19,0247 UKT 1801618027 0819/0009558        ,0.00,8200000,10221108257.29,19080900095580000051,
1020,09/08/2019,12:46:22,09/08/2019,12:46:22,0247 SPU 1939219009000 0819/0018013     ,0.00,750000,10221858257.29,19080900180130000031,
1021,09/08/2019,12:46:58,09/08/2019,12:46:58,0247 UKT 1939219009000 0819/0018013     ,0.00,1000000,10222858257.29,19080900180130000033,
1022,09/08/2019,12:54:25,09/08/2019,12:54:25,0247 UKT 1104617096 0819/0008573        ,0.00,4000000,10226858257.29,19080900085730000074,
1023,09/08/2019,13:03:15,09/08/2019,13:03:15,0247 UKT 1209618027 0819/0008300        ,0.00,4500000,10231358257.29,19080900083000000046,
1024,09/08/2019,13:04:03,09/08/2019,13:04:03,0247 UKT 1107618073 0819/0016993        ,0.00,3000000,10234358257.29,19080900169930000068,
1025,09/08/2019,13:05:07,09/08/2019,13:05:07,0247 UKT 1939219009266 0819/0013069     ,0.00,3000000,10237358257.29,19080900130690000036,
1026,09/08/2019,13:06:26,09/08/2019,13:06:26,0247 UKT 1939219015523 0819/0012936     ,0.00,6400000,10243758257.29,19080900129360000061,
1027,09/08/2019,13:07:52,09/08/2019,13:07:52,0247 UKT 1939119003448 0819/0008957     ,0.00,3950000,10247708257.29,19080900089570000038,
1028,09/08/2019,13:08:08,09/08/2019,13:08:08,0247 UKT 1939219015569 0819/0016527     ,0.00,4500000,10252208257.29,19080900165270000039,
1029,09/08/2019,13:10:33,09/08/2019,13:10:33,0247 UKT 1939219008511 0819/0013204     ,0.00,4700000,10256908257.29,19080900132040000106,
1030,09/08/2019,13:10:52,09/08/2019,13:10:52,0247 UKT 1939219011534 0819/0016491     ,0.00,1000000,10257908257.29,19080900164910000103,
1031,09/08/2019,13:11:09,09/08/2019,13:11:09,0247 UKT 1939219013557 0819/0016745     ,0.00,1000000,10258908257.29,19080900167450000141,
1032,09/08/2019,13:12:06,09/08/2019,13:12:06,0247 UKT 1939119003049 0819/0008219     ,0.00,6250000,10265158257.29,19080900082190000190,
1033,09/08/2019,13:12:23,09/08/2019,13:12:23,0247 SPU 1939119003049 0819/0008219     ,0.00,1000000,10266158257.29,19080900082190000192,
1034,09/08/2019,13:12:34,09/08/2019,13:12:34,0247 UKT 1205618092 0819/0016997        ,0.00,5900000,10272058257.29,19080900169970000043,
1035,09/08/2019,13:12:36,09/08/2019,13:12:36,0247 UKT 1801618152 0819/0007470        ,0.00,8200000,10280258257.29,19080900074700000126,
1036,09/08/2019,13:14:20,09/08/2019,13:14:20,0247 UKT 1939219017296 0819/0008219     ,0.00,5100000,10285358257.29,19080900082190000194,
1037,09/08/2019,13:14:46,09/08/2019,13:14:46,0247 UKT 1939219013358 0819/0010977     ,0.00,1000000,10286358257.29,19080900109770000069,
1038,09/08/2019,13:14:56,09/08/2019,13:14:56,0247 SPU 1939219017296 0819/0008219     ,0.00,10000000,10296358257.29,19080900082190000196,
1039,09/08/2019,13:15:40,09/08/2019,13:15:40,0247 SPU 1939219013557 0819/0016745     ,0.00,750000,10297108257.29,19080900167450000143,
1040,09/08/2019,13:16:02,09/08/2019,13:16:02,0247 UKT 1101617092 0819/0007901        ,0.00,4000000,10301108257.29,19080900079010000064,
1041,09/08/2019,13:17:04,09/08/2019,13:17:04,0247 UKT 1308618028 0819/0008225        ,0.00,4150000,10305258257.29,19080900082250000047,
1042,09/08/2019,13:17:11,09/08/2019,13:17:11,0247 UKT 1939219012197 0819/0011932     ,0.00,6400000,10311658257.29,19080900119320000032,
1043,09/08/2019,13:17:35,09/08/2019,13:17:35,0247 UKT 1107618032 0819/0008219        ,0.00,3000000,10314658257.29,19080900082190000198,
1044,09/08/2019,13:18:22,09/08/2019,13:18:22,0247 UKT 1601617162 0819/0008594        ,0.00,3400000,10318058257.29,19080900085940000033,
1045,09/08/2019,13:18:35,09/08/2019,13:18:35,0247 UKT 1303618038 0819/0008219        ,0.00,1000000,10319058257.29,19080900082190000200,
1046,09/08/2019,13:19:33,09/08/2019,13:19:33,0247 UKT 1939219000794 0819/0011952     ,0.00,2700000,10321758257.29,19080900119520000077,
1047,09/08/2019,13:19:50,09/08/2019,13:19:50,0247 UKT 1939219007292 0819/0017995     ,0.00,2700000,10324458257.29,19080900179950000029,
1048,09/08/2019,13:20:00,09/08/2019,13:20:00,0247 UKT 1303618040 0819/0012491        ,0.00,4500000,10328958257.29,19080900124910000019,
1049,09/08/2019,13:20:01,09/08/2019,13:20:01,0247 UKT 1204618051 0819/0016714        ,0.00,3900000,10332858257.29,19080900167140000072,
1050,09/08/2019,13:20:15,09/08/2019,13:20:15,0247 UKT 1939119002926 0819/0008219     ,0.00,6000000,10338858257.29,19080900082190000202,
1051,09/08/2019,13:20:25,09/08/2019,13:20:25,0247 UKT 1304618063 0819/0017990        ,0.00,4500000,10343358257.29,19080900179900000021,
1052,09/08/2019,13:20:25,09/08/2019,13:20:25,0247 UKT 1939219009990 0819/0013447     ,0.00,5400000,10348758257.29,19080900134470000071,
1053,09/08/2019,13:20:52,09/08/2019,13:20:52,0247 SPU 1939119002926 0819/0008219     ,0.00,750000,10349508257.29,19080900082190000204,
1054,09/08/2019,13:20:52,09/08/2019,13:20:52,0247 UKT 1602617114 0819/0016525        ,0.00,4700000,10354208257.29,19080900165250000114,
1055,09/08/2019,13:21:21,09/08/2019,13:21:21,0247 UKT 1939219007725 0819/0010962     ,0.00,5100000,10359308257.29,19080900109620000021,
1056,09/08/2019,13:22:20,09/08/2019,13:22:20,0247 SPU 1939219007725 0819/0010962     ,0.00,2000000,10361308257.29,19080900109620000024,
1057,09/08/2019,13:22:25,09/08/2019,13:22:25,0247 UKT 1305617026 0819/0016488        ,0.00,9000000,10370308257.29,19080900164880000038,
1058,09/08/2019,13:23:19,09/08/2019,13:23:19,0247 UKT 1939319000515 0819/0008561     ,0.00,3200000,10373508257.29,19080900085610000039,
1059,09/08/2019,13:23:38,09/08/2019,13:23:38,0247 UKT 1939219009825 0819/0008219     ,0.00,3900000,10377408257.29,19080900082190000206,
1060,09/08/2019,13:25:26,09/08/2019,13:25:26,0247 UKT 1301618009 0819/0008219        ,0.00,5000000,10382408257.29,19080900082190000208,
1061,09/08/2019,13:26:51,09/08/2019,13:26:51,0247 UKT 1939219000975 0819/0007014     ,0.00,5300000,10387708257.29,19080900070140000059,
1062,09/08/2019,13:26:56,09/08/2019,13:26:56,0247 UKT 1801617017 0819/0016714        ,0.00,10300000,10398008257.29,19080900167140000074,
1063,09/08/2019,13:27:48,09/08/2019,13:27:48,0247 UKT 1939319000909 0819/0017987     ,0.00,3200000,10401208257.29,19080900179870000017,
1064,09/08/2019,13:28:23,09/08/2019,13:28:23,0247 UKT 1939319000246 0819/0016716     ,0.00,1000000,10402208257.29,19080900167160000045,
1065,09/08/2019,13:28:31,09/08/2019,13:28:31,0247 UKT 1303618041 0819/0016631        ,0.00,3950000,10406158257.29,19080900166310000031,
1066,09/08/2019,13:28:51,09/08/2019,13:28:51,0247 SPU 1939219000251 0819/0016995     ,0.00,12000000,10418158257.29,19080900169950000169,
1067,09/08/2019,13:29:33,09/08/2019,13:29:33,0247 SPU 1939219000975 0819/0007014     ,0.00,3000000,10421158257.29,19080900070140000061,
1068,09/08/2019,13:30:07,09/08/2019,13:30:07,0247 UKT 1939219012063 0819/0008219     ,0.00,5100000,10426258257.29,19080900082190000211,
1069,09/08/2019,13:30:11,09/08/2019,13:30:11,0247 UKT 1939219000251 0819/0016995     ,0.00,5800000,10432058257.29,19080900169950000171,
1070,09/08/2019,13:31:24,09/08/2019,13:31:24,0247 SPU 1939219012063 0819/0008219     ,0.00,1000000,10433058257.29,19080900082190000214,
1071,09/08/2019,13:31:41,09/08/2019,13:31:41,0247 UKT                                ,0.00,6700000,10439758257.29,19080999296020691710,
1072,09/08/2019,13:31:41,09/08/2019,13:31:41,0247 UKT 1939219009079 0819/0010411     ,0.00,6700000,10446458257.29,19080900104110000050,
1073,09/08/2019,13:31:59,09/08/2019,13:31:59,0247 UKT 1939119001817 0819/0017989     ,0.00,4300000,10450758257.29,19080900179890000080,
1074,09/08/2019,13:32:33,09/08/2019,13:32:33,0247 UKT 1939219017243 0819/0011831     ,0.00,5300000,10456058257.29,19080900118310000043,
1075,09/08/2019,13:32:40,09/08/2019,13:32:40,0247 UKT 1939119000672 0819/0013469     ,0.00,6200000,10462258257.29,19080900134690000112,
1076,09/08/2019,13:32:49,09/08/2019,13:32:49,0247 UKT 1603617090 0819/0016544        ,0.00,6500000,10468758257.29,19080900165440000068,
1077,09/08/2019,13:33:05,09/08/2019,13:33:05,0247 UKT 1203617056 0819/0008219        ,0.00,3700000,10472458257.29,19080900082190000216,
1078,09/08/2019,13:33:32,09/08/2019,13:33:32,0247 SPU 1939219009079 0819/0010411     ,0.00,1000000,10473458257.29,19080900104110000052,
1079,09/08/2019,13:34:03,09/08/2019,13:34:03,0247 SPU 1939119001786 0819/0016700     ,0.00,1000000,10474458257.29,19080900167000000114,
1080,09/08/2019,13:34:20,09/08/2019,13:34:20,0247 SPU 1939219017243 0819/0011831     ,0.00,2000000,10476458257.29,19080900118310000045,
1081,09/08/2019,13:34:22,09/08/2019,13:34:22,0247 UKT 1939119001786 0819/0016700     ,0.00,4000000,10480458257.29,19080900167000000116,
1082,09/08/2019,13:34:28,09/08/2019,13:34:28,0247 UKT 1107617047 0819/0009627        ,0.00,3000000,10483458257.29,19080900096270000046,
1083,09/08/2019,13:34:52,09/08/2019,13:34:52,0247 UKT 1602618029 0819/0008219        ,0.00,3400000,10486858257.29,19080900082190000218,
1084,09/08/2019,13:35:08,09/08/2019,13:35:08,0247 UKT 1201618029 0819/0013482        ,0.00,6000000,10492858257.29,19080900134820000116,
1085,09/08/2019,13:35:15,09/08/2019,13:35:15,0247 UKT 1939219001884 0819/0008281     ,0.00,3000000,10495858257.29,19080900082810000061,
1086,09/08/2019,13:35:28,09/08/2019,13:35:28,0247 SPU 1939219011867 0819/0016716     ,0.00,1500000,10497358257.29,19080900167160000050,
1087,09/08/2019,13:35:30,09/08/2019,13:35:30,0247 UKT 1202617009 0819/0013436        ,0.00,5900000,10503258257.29,19080900134360000139,
1088,09/08/2019,13:35:50,09/08/2019,13:35:50,0247 UKT 1801617160 0819/0016544        ,0.00,6200000,10509458257.29,19080900165440000070,
1089,09/08/2019,13:36:07,09/08/2019,13:36:07,0247 UKT 1939219011867 0819/0016716     ,0.00,5100000,10514558257.29,19080900167160000052,
1090,09/08/2019,13:36:53,09/08/2019,13:36:53,0247 SPU 1939219001884 0819/0008281     ,0.00,1500000,10516058257.29,19080900082810000063,
1091,09/08/2019,13:37:00,09/08/2019,13:37:00,0247 UKT 1602618059 0819/0013048        ,0.00,4700000,10520758257.29,19080900130480000209,
1092,09/08/2019,13:37:10,09/08/2019,13:37:10,0247 UKT 1801618025 0819/0013811        ,0.00,8200000,10528958257.29,19080900138110000061,
1093,09/08/2019,13:37:19,09/08/2019,13:37:19,0247 UKT 1939219010127 0819/0008219     ,0.00,5600000,10534558257.29,19080900082190000220,
1094,09/08/2019,13:37:47,09/08/2019,13:37:47,0247 UKT 1939119002062 0819/0006645     ,0.00,6200000,10540758257.29,19080900066450000156,
1095,09/08/2019,13:38:04,09/08/2019,13:38:04,0247 UKT 1939219007528 0819/0013436     ,0.00,1000000,10541758257.29,19080900134360000141,
1096,09/08/2019,13:38:04,09/08/2019,13:38:04,0247 UKT 1939319001012 0819/0016658     ,0.00,1000000,10542758257.29,19080900166580000016,
1097,09/08/2019,13:38:29,09/08/2019,13:38:29,0247 SPU 1939219007528 0819/0013436     ,0.00,750000,10543508257.29,19080900134360000143,
1098,09/08/2019,13:39:10,09/08/2019,13:39:10,0247 UKT 1939119002667 0819/0016525     ,0.00,5200000,10548708257.29,19080900165250000117,
1099,09/08/2019,13:39:51,09/08/2019,13:39:51,0247 UKT                                ,0.00,4600000,10553308257.29,19080999131020764099,
1100,09/08/2019,13:40:06,09/08/2019,13:40:06,0247 UKT 1211617049 0819/0008219        ,0.00,3700000,10557008257.29,19080900082190000222,
1101,09/08/2019,13:41:09,09/08/2019,13:41:09,0247 UKT 1102618007 0819/0010978        ,0.00,3000000,10560008257.29,19080900109780000101,
1102,09/08/2019,13:41:10,09/08/2019,13:41:10,0247 UKT 1939119003280 0819/0010761     ,0.00,7500000,10567508257.29,19080900107610000143,
1103,09/08/2019,13:41:14,09/08/2019,13:41:14,0247 UKT 1801618118 0819/0010977        ,0.00,7200000,10574708257.29,19080900109770000073,
1104,09/08/2019,13:41:22,09/08/2019,13:41:22,0247 UKT 1939219001921 0819/0016716     ,0.00,1000000,10575708257.29,19080900167160000054,
1105,09/08/2019,13:42:23,09/08/2019,13:42:23,0247 UKT 1939219014622 0819/0017963     ,0.00,4000000,10579708257.29,19080900179630000049,
1106,09/08/2019,13:42:38,09/08/2019,13:42:38,0247 UKT 1939119001099 0819/0017996     ,0.00,1000000,10580708257.29,19080900179960000127,
1107,09/08/2019,13:42:38,09/08/2019,13:42:38,0247 UKT 1939219004019 0819/0008219     ,0.00,3900000,10584608257.29,19080900082190000224,
1108,09/08/2019,13:44:00,09/08/2019,13:44:00,0247 UKT 1102618065 0819/0017756        ,0.00,5100000,10589708257.29,19080900177560000065,
1109,09/08/2019,13:45:32,09/08/2019,13:45:32,0247 SPU 1939119000281 0819/0008953     ,0.00,750000,10590458257.29,19080900089530000146,
1110,09/08/2019,13:45:58,09/08/2019,13:45:58,0247 UKT 1939119000281 0819/0008953     ,0.00,6250000,10596708257.29,19080900089530000148,
1111,09/08/2019,13:46:08,09/08/2019,13:46:08,0247 UKT 1208618046 0819/0017980        ,0.00,5900000,10602608257.29,19080900179800000106,
1112,09/08/2019,13:47:07,09/08/2019,13:47:07,0247 SPU 1939119001721 0819/0013487     ,0.00,750000,10603358257.29,19080900134870000076,
1113,09/08/2019,13:47:24,09/08/2019,13:47:24,0247 UKT 1939219007320 0819/0010423     ,0.00,1000000,10604358257.29,19080900104230000084,
1114,09/08/2019,13:47:46,09/08/2019,13:47:46,0247 UKT 1307618024 0819/0008220        ,0.00,6250000,10610608257.29,19080900082200000036,
1115,09/08/2019,13:47:50,09/08/2019,13:47:50,0247 UKT 1939219011941 0819/0016655     ,0.00,4500000,10615108257.29,19080900166550000106,
1116,09/08/2019,13:48:15,09/08/2019,13:48:15,0247 UKT 1939119001721 0819/0013487     ,0.00,6200000,10621308257.29,19080900134870000078,
1117,09/08/2019,13:48:54,09/08/2019,13:48:54,0247 UKT 1939219002688 0819/0013057     ,0.00,4700000,10626008257.29,19080900130570000065,
1118,09/08/2019,13:49:06,09/08/2019,13:49:06,0247 UKT 1106617045 0819/0006645        ,0.00,3000000,10629008257.29,19080900066450000164,
1119,09/08/2019,13:49:22,09/08/2019,13:49:22,0247 UKT 1939219008458 0819/0008587     ,0.00,1000000,10630008257.29,19080900085870000024,
1120,09/08/2019,13:49:28,09/08/2019,13:49:28,0247 UKT 1210618050 0819/0016491        ,0.00,6900000,10636908257.29,19080900164910000125,
1121,09/08/2019,13:49:48,09/08/2019,13:49:48,0247 UKT 1603617067 0819/0016484        ,0.00,4300000,10641208257.29,19080900164840000201,
1122,09/08/2019,13:50:12,09/08/2019,13:50:12,0247 SPU 1939219011941 0819/0016655     ,0.00,1000000,10642208257.29,19080900166550000109,
1123,09/08/2019,13:50:21,09/08/2019,13:50:21,0247 UKT 1939219012134 0819/0016526     ,0.00,5600000,10647808257.29,19080900165260000075,
1124,09/08/2019,13:51:05,09/08/2019,13:51:05,0247 UKT 1302618013 0819/0010758        ,0.00,6000000,10653808257.29,19080900107580000049,
1125,09/08/2019,13:51:21,09/08/2019,13:51:21,0247 UKT 1939219010353 0819/0006669     ,0.00,1000000,10654808257.29,19080900066690000065,
1126,09/08/2019,13:51:34,09/08/2019,13:51:34,0247 SPU 1939219012134 0819/0016526     ,0.00,3000000,10657808257.29,19080900165260000077,
1127,09/08/2019,13:52:09,09/08/2019,13:52:09,0247 UKT 1801617198 0819/0008219        ,0.00,4000000,10661808257.29,19080900082190000232,
1128,09/08/2019,13:52:18,09/08/2019,13:52:18,0247 UKT 1208617020 0819/0017800        ,0.00,4500000,10666308257.29,19080900178000000203,
1129,09/08/2019,13:53:12,09/08/2019,13:53:12,0247 UKT 1101617105 0819/0007348        ,0.00,4000000,10670308257.29,19080900073480000166,
1130,09/08/2019,13:53:48,09/08/2019,13:53:48,0247 UKT 1313617021 0819/0010977        ,0.00,6200000,10676508257.29,19080900109770000075,
1131,09/08/2019,13:54:36,09/08/2019,13:54:36,0247 UKT 1302618009 0819/0016688        ,0.00,6000000,10682508257.29,19080900166880000104,
1132,09/08/2019,13:54:47,09/08/2019,13:54:47,0247 SPU 1939119000970 0819/0008219     ,0.00,1000000,10683508257.29,19080900082190000234,
1133,09/08/2019,13:55:04,09/08/2019,13:55:04,0247 UKT 1801618151 0819/0013469        ,0.00,6200000,10689708257.29,19080900134690000126,
1134,09/08/2019,13:56:25,09/08/2019,13:56:25,0247 SPU 1939219003902 0819/0008219     ,0.00,750000,10690458257.29,19080900082190000236,
1135,09/08/2019,13:57:11,09/08/2019,13:57:11,0247 SPU 1939319000011 0819/0016700     ,0.00,750000,10691208257.29,19080900167000000126,
1136,09/08/2019,13:57:29,09/08/2019,13:57:29,0247 UKT 1939319000011 0819/0016700     ,0.00,6500000,10697708257.29,19080900167000000128,
1137,09/08/2019,13:58:58,09/08/2019,13:58:58,0247 UKT 1939219009202 0819/0008207     ,0.00,1000000,10698708257.29,19080900082070000129,
1138,09/08/2019,13:59:31,09/08/2019,13:59:31,0247 UKT 1939219006070 0819/0017768     ,0.00,5400000,10704108257.29,19080900177680000040,
1139,09/08/2019,14:00:05,09/08/2019,14:00:05,0247 SPU 1939219009202 0819/0008207     ,0.00,1000000,10705108257.29,19080900082070000131,
1140,09/08/2019,14:00:51,09/08/2019,14:00:51,0247 UKT 1801617180 0819/0016657        ,0.00,6200000,10711308257.29,19080900166570000077,
1141,09/08/2019,14:01:27,09/08/2019,14:01:27,0247 UKT 1202618017 0819/0008219        ,0.00,6100000,10717408257.29,19080900082190000242,
1142,09/08/2019,14:03:19,09/08/2019,14:03:19,0247 UKT 1939219005972 0819/0018006     ,0.00,8200000,10725608257.29,19080900180060000061,
1143,09/08/2019,14:03:43,09/08/2019,14:03:43,0247 UKT 1303618031 0819/0017001        ,0.00,6200000,10731808257.29,19080900170010000115,
1144,09/08/2019,14:04:26,09/08/2019,14:04:26,0247 UKT 1207618027 0819/0012245        ,0.00,6700000,10738508257.29,19080900122450000121,
1145,09/08/2019,14:05:14,09/08/2019,14:05:14,0247 UKT 1107618074 0819/0016999        ,0.00,5100000,10743608257.29,19080900169990000114,
1146,09/08/2019,14:05:19,09/08/2019,14:05:19,0247 UKT 1939219009853 0819/0010977     ,0.00,2700000,10746308257.29,19080900109770000081,
1147,09/08/2019,14:05:22,09/08/2019,14:05:22,0247 UKT 1308617056 0819/0008219        ,0.00,4150000,10750458257.29,19080900082190000244,
1148,09/08/2019,14:05:36,09/08/2019,14:05:36,0247 UKT 1106618060 0819/0016613        ,0.00,5100000,10755558257.29,19080900166130000050,
1149,09/08/2019,14:06:00,09/08/2019,14:06:00,0247 SPU 1939219009853 0819/0010977     ,0.00,750000,10756308257.29,19080900109770000083,
1150,09/08/2019,14:06:14,09/08/2019,14:06:14,0247 UKT 1939219006225 0819/0011549     ,0.00,3900000,10760208257.29,19080900115490000019,
1151,09/08/2019,14:08:08,09/08/2019,14:08:08,0247 UKT 1304617040 0819/0012476        ,0.00,3950000,10764158257.29,19080900124760000085,
1152,09/08/2019,14:08:18,09/08/2019,14:08:18,0247 UKT 1939219009025 0819/0011831     ,0.00,5100000,10769258257.29,19080900118310000051,
1153,09/08/2019,14:08:25,09/08/2019,14:08:25,0247 UKT 1939219007033 0819/0016716     ,0.00,1000000,10770258257.29,19080900167160000072,
1154,09/08/2019,14:08:48,09/08/2019,14:08:48,0247 UKT 1939219010767 0819/0016436     ,0.00,6700000,10776958257.29,19080900164360000106,
1155,09/08/2019,14:08:49,09/08/2019,14:08:49,0247 UKT 1939219014527 0819/0008219     ,0.00,5300000,10782258257.29,19080900082190000246,
1156,09/08/2019,14:09:43,09/08/2019,14:09:43,0247 UKT 1939219002111 0819/0011952     ,0.00,4000000,10786258257.29,19080900119520000132,
1157,09/08/2019,14:10:35,09/08/2019,14:10:35,0247 UKT 1939219002913 0819/0008219     ,0.00,1000000,10787258257.29,19080900082190000248,
1158,09/08/2019,14:10:42,09/08/2019,14:10:42,0247 SPU 1939219001190 0819/0008937     ,0.00,750000,10788008257.29,19080900089370000042,
1159,09/08/2019,14:11:23,09/08/2019,14:11:23,0247 UKT 1939219001190 0819/0008937     ,0.00,6700000,10794708257.29,19080900089370000044,
1160,09/08/2019,14:11:56,09/08/2019,14:11:56,0247 SPU 1939219010767 0819/0016436     ,0.00,750000,10795458257.29,19080900164360000108,
1161,09/08/2019,14:12:05,09/08/2019,14:12:05,0247 UKT 1107617173 0819/0008219        ,0.00,3000000,10798458257.29,19080900082190000250,
1162,09/08/2019,14:13:11,09/08/2019,14:13:11,0247 UKT 1307617027 0819/0008219        ,0.00,4150000,10802608257.29,19080900082190000252,
1163,09/08/2019,14:13:37,09/08/2019,14:13:37,0247 SPU 1939219005521 0819/0016660     ,0.00,10000000,10812608257.29,19080900166600000085,
1164,09/08/2019,14:13:42,09/08/2019,14:13:42,0247 UKT 1939219002929 0819/0016657     ,0.00,5100000,10817708257.29,19080900166570000084,
1165,09/08/2019,14:15:25,09/08/2019,14:15:25,0247 UKT 1939219008831 0819/0007897     ,0.00,1000000,10818708257.29,19080900078970000032,
1166,09/08/2019,14:15:34,09/08/2019,14:15:34,0247 UKT 1939219009315 0819/0008219     ,0.00,5900000,10824608257.29,19080900082190000254,
1167,09/08/2019,14:16:00,09/08/2019,14:16:00,0247 SPU 1939219009315 0819/0008219     ,0.00,800000,10825408257.29,19080900082190000257,
1168,09/08/2019,14:16:44,09/08/2019,14:16:44,0247 UKT 1939219008267 0819/0013065     ,0.00,500000,10825908257.29,19080900130650000053,
1169,09/08/2019,14:16:49,09/08/2019,14:16:49,0247 UKT 1939119002428 0819/0013497     ,0.00,4500000,10830408257.29,19080900134970000114,
1170,09/08/2019,14:17:05,09/08/2019,14:17:05,0247 UKT 1939119003212 0819/0017995     ,0.00,6250000,10836658257.29,19080900179950000040,
1171,09/08/2019,14:18:23,09/08/2019,14:18:23,0247 UKT 1939219015003 0819/0016439     ,0.00,5900000,10842558257.29,19080900164390000072,
1172,09/08/2019,14:18:40,09/08/2019,14:18:40,0247 UKT 1939219000228 0819/0013446     ,0.00,8600000,10851158257.29,19080900134460000095,
1173,09/08/2019,14:19:13,09/08/2019,14:19:13,0247 UKT 1107617269 0819/0008561        ,0.00,5100000,10856258257.29,19080900085610000045,
1174,09/08/2019,14:19:15,09/08/2019,14:19:15,0247 SPU 1939219015003 0819/0016439     ,0.00,2000000,10858258257.29,19080900164390000074,
1175,09/08/2019,14:21:03,09/08/2019,14:21:03,0247 UKT 1204618028 0819/0011958        ,0.00,1000000,10859258257.29,19080900119580000206,
1176,09/08/2019,14:21:05,09/08/2019,14:21:05,0247 UKT 1939119002558 0819/0013447     ,0.00,6200000,10865458257.29,19080900134470000087,
1177,09/08/2019,14:21:37,09/08/2019,14:21:37,0247 UKT 1939119003363 0819/0008555     ,0.00,1000000,10866458257.29,19080900085550000064,
1178,09/08/2019,14:24:37,09/08/2019,14:24:37,0247 UKT 1939219001834 0819/0016657     ,0.00,3000000,10869458257.29,19080900166570000086,
1179,09/08/2019,14:25:14,09/08/2019,14:25:14,0247 UKT 1939219011008 0819/0016544     ,0.00,3900000,10873358257.29,19080900165440000092,
1180,09/08/2019,14:26:03,09/08/2019,14:26:03,0247 SPU 1939219011008 0819/0016544     ,0.00,3000000,10876358257.29,19080900165440000095,
1181,09/08/2019,14:26:29,09/08/2019,14:26:29,0247 UKT 1939219010547 0819/0008246     ,0.00,3900000,10880258257.29,19080900082460000151,
1182,09/08/2019,14:26:52,09/08/2019,14:26:52,0247 SPU 1939219010547 0819/0008246     ,0.00,1000000,10881258257.29,19080900082460000153,
1183,09/08/2019,14:28:03,09/08/2019,14:28:03,0247 UKT 1939219007888 0819/0016652     ,0.00,5600000,10886858257.29,19080900166520000098,
1184,09/08/2019,14:28:33,09/08/2019,14:28:33,0247 UKT 1939219007115 0819/0012492     ,0.00,6202000,10893060257.29,19080900124920000007,
1185,09/08/2019,14:30:56,09/08/2019,14:30:56,0247 UKT 1939219010916 0819/0008246     ,0.00,5100000,10898160257.29,19080900082460000155,
1186,09/08/2019,14:31:17,09/08/2019,14:31:17,0247 SPU 1939219010916 0819/0008246     ,0.00,5000000,10903160257.29,19080900082460000157,
1187,09/08/2019,14:31:35,09/08/2019,14:31:35,0247 UKT 1939219012282 0819/0010947     ,0.00,5800000,10908960257.29,19080900109470000081,
1188,09/08/2019,14:32:51,09/08/2019,14:32:51,0247 SPU 1939319000658 0819/0013799     ,0.00,2000000,10910960257.29,19080900137990000058,
1189,09/08/2019,14:33:02,09/08/2019,14:33:02,0247 UKT 1939119003411 0819/0018004     ,0.00,1000000,10911960257.29,19080900180040000048,
1190,09/08/2019,14:33:22,09/08/2019,14:33:22,0247 UKT 1939319000658 0819/0013799     ,0.00,5900000,10917860257.29,19080900137990000060,
1191,09/08/2019,14:34:36,09/08/2019,14:34:36,0247 UKT 1939119000964 0819/0012923     ,0.00,3200000,10921060257.29,19080900129230000192,
1192,09/08/2019,14:35:12,09/08/2019,14:35:12,0247 SPU 1939119000964 0819/0012923     ,0.00,750000,10921810257.29,19080900129230000194,
1193,09/08/2019,14:35:43,09/08/2019,14:35:43,0247 UKT 1939219008276 0819/0007168     ,0.00,1000000,10922810257.29,19080900071680000237,
1194,09/08/2019,14:35:49,09/08/2019,14:35:49,0247 UKT 1308618042 0819/0017002        ,0.00,6250000,10929060257.29,19080900170020000044,
1195,09/08/2019,14:36:01,09/08/2019,14:36:01,0247 UKT 1801618031 0819/0017964        ,0.00,4000000,10933060257.29,19080900179640000048,
1196,09/08/2019,14:36:13,09/08/2019,14:36:13,0247 SPU 1939219008276 0819/0007168     ,0.00,750000,10933810257.29,19080900071680000240,
1197,09/08/2019,14:36:47,09/08/2019,14:36:47,0247 UKT 1603617039 0819/0008594        ,0.00,5400000,10939210257.29,19080900085940000045,
1198,09/08/2019,14:37:50,09/08/2019,14:37:50,0247 UKT 1601618020 0819/0012490        ,0.00,3400000,10942610257.29,19080900124900000057,
1199,09/08/2019,14:38:18,09/08/2019,14:38:18,0247 UKT 1939219000136 0819/0009627     ,0.00,5100000,10947710257.29,19080900096270000054,
1200,09/08/2019,14:38:43,09/08/2019,14:38:43,0247 UKT 1303618068 0819/0008244        ,0.00,3950000,10951660257.29,19080900082440000054,
1201,09/08/2019,14:40:34,09/08/2019,14:40:34,0247 SPU 1939219000136 0819/0009627     ,0.00,10000000,10961660257.29,19080900096270000056,
1202,09/08/2019,14:49:12,09/08/2019,14:49:12,0247 UKT 1302618011 0819/0007348        ,0.00,3800000,10965460257.29,19080900073480000175,
1203,09/08/2019,14:51:15,09/08/2019,14:51:15,0247 UKT 1801617051 0819/0013503        ,0.00,4000000,10969460257.29,19080900135030000165,
1204,09/08/2019,14:54:01,09/08/2019,14:54:01,0247 SPU 1939219001339 0819/0010970     ,0.00,750000,10970210257.29,19080900109700000127,
1205,09/08/2019,14:54:36,09/08/2019,14:54:36,0247 UKT 1939219001339 0819/0010970     ,0.00,4700000,10974910257.29,19080900109700000129,
1206,09/08/2019,14:54:37,09/08/2019,14:54:37,0247 UKT 1939119001396 0819/0008219     ,0.00,1000000,10975910257.29,19080900082190000260,
1207,09/08/2019,14:54:53,09/08/2019,14:54:53,0247 SPU 1939119001396 0819/0008219     ,0.00,1000000,10976910257.29,19080900082190000262,
1208,09/08/2019,14:56:45,09/08/2019,14:56:45,0247 UKT 1102618015 0819/0008219        ,0.00,1000000,10977910257.29,19080900082190000264,
1209,09/08/2019,14:58:53,09/08/2019,14:58:53,0247 UKT 1939219002734 0819/0018009     ,0.00,6700000,10984610257.29,19080900180090000048,
1210,09/08/2019,14:59:14,09/08/2019,14:59:14,0247 UKT 1308618030 0819/0008219        ,0.00,6250000,10990860257.29,19080900082190000266,
1211,09/08/2019,15:01:13,09/08/2019,15:01:13,0247 UKT 1939319000386 0819/0008219     ,0.00,5800000,10996660257.29,19080900082190000268,
1212,09/08/2019,15:01:32,09/08/2019,15:01:32,0247 SPU 1939319000386 0819/0008219     ,0.00,2000000,10998660257.29,19080900082190000270,
1213,09/08/2019,15:03:14,09/08/2019,15:03:14,0247 UKT 1801617269 0819/0008573        ,0.00,7200000,11005860257.29,19080900085730000088,
1214,09/08/2019,15:03:40,09/08/2019,15:03:40,0247 UKT 1939219016760 0819/0008309     ,0.00,5600000,11011460257.29,19080900083090000090,
1215,09/08/2019,15:15:50,09/08/2019,15:15:50,0247 UKT 1801617188 0819/0007895        ,0.00,6200000,11017660257.29,19080900078950000048,
1216,09/08/2019,15:16:14,09/08/2019,15:16:14,0247 UKT 1939219007057 0819/0016525     ,0.00,1000000,11018660257.29,19080900165250000146,
1217,09/08/2019,15:17:27,09/08/2019,15:17:27,0247 UKT                                ,0.00,6200000,11024860257.29,19080999379090572799,
1218,09/08/2019,15:18:13,09/08/2019,15:18:13,0247 UKT 1939219003969 0819/0008219     ,0.00,5800000,11030660257.29,19080900082190000278,
1219,09/08/2019,15:18:32,09/08/2019,15:18:32,0247 SPU 1939219003969 0819/0008219     ,0.00,2000000,11032660257.29,19080900082190000280,
1220,09/08/2019,15:18:43,09/08/2019,15:18:43,0247 UKT 1302617053 0819/0013080        ,0.00,6000000,11038660257.29,19080900130800000083,
1221,09/08/2019,15:22:43,09/08/2019,15:22:43,0247 SPU 1939219002688 0819/0013182     ,0.00,750000,11039410257.29,19080900131820000128,
1222,09/08/2019,15:25:18,09/08/2019,15:25:18,0247 UKT 1939119003555 0819/0018004     ,0.00,5200000,11044610257.29,19080900180040000052,
1223,09/08/2019,16:48:10,09/08/2019,16:48:10,0247 UKT                                ,0.00,4150000,11048760257.29,19080999179100384512,
1224,09/08/2019,17:28:37,09/08/2019,17:28:37,0247 UKT                                ,0.00,5100000,11053860257.29,19080999234010705369,
1225,09/08/2019,18:15:23,09/08/2019,18:15:23,0247 UKT                                ,0.00,5100000,11058960257.29,19080999547010020765,
1226,09/08/2019,19:51:04,09/08/2019,19:51:04,0247 UKT                                ,0.00,1000000,11059960257.29,19080999488010678265,
1227,10/08/2019,11:26:50,10/08/2019,11:26:50,0247 UKT                                ,0.00,5100000,11065060257.29,19081099226020863336,
1228,10/08/2019,17:03:16,10/08/2019,17:03:16,0247 UKT                                ,0.00,3000000,11068060257.29,19081099113810304890,
1229,11/08/2019,14:40:31,11/08/2019,14:40:31,0247 UKT                                ,0.00,500000,11068560257.29,19081199200010267090,
1230,12/08/2019,08:03:58,12/08/2019,08:03:58,0247 UKT 1939119003540 0819/0013482     ,0.00,7500000,11076060257.29,19081200134820000002,
1231,12/08/2019,08:06:06,12/08/2019,08:06:06,0247 SPU 1939119003540 0819/0013482     ,0.00,5000000,11081060257.29,19081200134820000004,
1232,12/08/2019,08:06:28,12/08/2019,08:06:28,0247 UKT 1301617007 0819/0012491        ,0.00,6000000,11087060257.29,19081200124910000002,
1233,12/08/2019,08:07:04,12/08/2019,08:07:04,0247 UKT 1939219012657 0819/0008225     ,0.00,3000000,11090060257.29,19081200082250000002,
1234,12/08/2019,08:07:06,12/08/2019,08:07:06,0247 UKT 1939219004088 0819/0013446     ,0.00,5900000,11095960257.29,19081200134460000004,
1235,12/08/2019,08:08:06,12/08/2019,08:08:06,0247 UKT 1106618007 0819/0017783        ,0.00,3900000,11099860257.29,19081200177830000003,
1236,12/08/2019,08:10:35,12/08/2019,08:10:35,0247 UKT 1939219009992 0819/0010411     ,0.00,1000000,11100860257.29,19081200104110000006,
1237,12/08/2019,08:12:20,12/08/2019,08:12:20,0247 UKT 1939219011985 0819/0008219     ,0.00,1000000,11101860257.29,19081200082190000002,
1238,12/08/2019,08:14:05,12/08/2019,08:14:05,0247 UKT 1939119001957 0819/0008219     ,0.00,7500000,11109360257.29,19081200082190000004,
1239,12/08/2019,08:14:23,12/08/2019,08:14:23,0247 SPU 1939119001957 0819/0008219     ,0.00,1500000,11110860257.29,19081200082190000006,
1240,12/08/2019,08:14:40,12/08/2019,08:14:40,0247 UKT 1939119001463 0819/0012247     ,0.00,6250000,11117110257.29,19081200122470000002,
1241,12/08/2019,08:15:21,12/08/2019,08:15:21,0247 SPU 1939119001463 0819/0012247     ,0.00,15000000,11132110257.29,19081200122470000004,
1242,12/08/2019,08:16:23,12/08/2019,08:16:23,0247 UKT 1939319000242 0819/0008219     ,0.00,5100000,11137210257.29,19081200082190000008,
1243,12/08/2019,08:17:53,12/08/2019,08:17:53,0247 SPU 1939219012282 0819/0013487     ,0.00,15000000,11152210257.29,19081200134870000008,
1244,12/08/2019,08:21:03,12/08/2019,08:21:03,0247 UKT 1939219002014 0819/0008953     ,0.00,8200000,11160410257.29,19081200089530000020,
1245,12/08/2019,08:22:18,12/08/2019,08:22:18,0247 UKT 1308618006 0819/0013487        ,0.00,6250000,11166660257.29,19081200134870000010,
1246,12/08/2019,08:22:26,12/08/2019,08:22:26,0247 UKT 1939219005860 0819/0008219     ,0.00,5600000,11172260257.29,19081200082190000010,
1247,12/08/2019,08:22:42,12/08/2019,08:22:42,0247 SPU 1939219005860 0819/0008219     ,0.00,5000000,11177260257.29,19081200082190000012,
1248,12/08/2019,08:22:44,12/08/2019,08:22:44,0247 UKT 1939219004394 0819/0016484     ,0.00,5100000,11182360257.29,19081200164840000012,
1249,12/08/2019,08:23:05,12/08/2019,08:23:05,0247 SPU 1939219002014 0819/0008953     ,0.00,20000000,11202360257.29,19081200089530000022,
1250,12/08/2019,08:24:37,12/08/2019,08:24:37,0247 UKT 1939119002837 0819/0010961     ,0.00,3800000,11206160257.29,19081200109610000009,
1251,12/08/2019,08:25:10,12/08/2019,08:25:10,0247 UKT 1939319000528 0819/0008219     ,0.00,1000000,11207160257.29,19081200082190000014,
1252,12/08/2019,08:26:01,12/08/2019,08:26:01,0247 UKT 1939219012719 0819/0008219     ,0.00,1000000,11208160257.29,19081200082190000016,
1253,12/08/2019,08:26:21,12/08/2019,08:26:21,0247 SPU 1939119002837 0819/0010961     ,0.00,750000,11208910257.29,19081200109610000011,
1254,12/08/2019,08:28:50,12/08/2019,08:28:50,0247 UKT 1939119001231 0819/0009772     ,0.00,6200000,11215110257.29,19081200097720000021,
1255,12/08/2019,08:29:00,12/08/2019,08:29:00,0247 UKT 1939219011335 0819/0010960     ,0.00,1000000,11216110257.29,19081200109600000022,
1256,12/08/2019,08:29:31,12/08/2019,08:29:31,0247 UKT 1939219010342 0819/0007248     ,0.00,4300000,11220410257.29,19081200072480000012,
1257,12/08/2019,08:29:35,12/08/2019,08:29:35,0247 UKT 1301618024 0819/0013447        ,0.00,4300000,11224710257.29,19081200134470000008,
1258,12/08/2019,08:29:35,12/08/2019,08:29:35,0247 UKT 1939219004360 0819/0012490     ,0.00,4500000,11229210257.29,19081200124900000006,
1259,12/08/2019,08:30:12,12/08/2019,08:30:12,0247 SPU 1939119001231 0819/0009772     ,0.00,20000000,11249210257.29,19081200097720000023,
1260,12/08/2019,08:30:52,12/08/2019,08:30:52,0247 UKT 1102618059 0819/0007887        ,0.00,5100000,11254310257.29,19081200078870000008,
1261,12/08/2019,08:32:22,12/08/2019,08:32:22,0247 UKT 1939219009736 0819/0016491     ,0.00,5300000,11259610257.29,19081200164910000007,
1262,12/08/2019,08:32:41,12/08/2019,08:32:41,0247 UKT 1939219016394 0819/0008214     ,0.00,5800000,11265410257.29,19081200082140000006,
1263,12/08/2019,08:32:50,12/08/2019,08:32:50,0247 SPU 1939219008184 0819/0008219     ,0.00,750000,11266160257.29,19081200082190000019,
1264,12/08/2019,08:33:19,12/08/2019,08:33:19,0247 UKT 1939219014862 0819/0018000     ,0.00,3000000,11269160257.29,19081200180000000004,
1265,12/08/2019,08:33:20,12/08/2019,08:33:20,0247 SPU 1939219016394 0819/0008214     ,0.00,3000000,11272160257.29,19081200082140000008,
1266,12/08/2019,08:33:48,12/08/2019,08:33:48,0247 UKT 1939219010133 0819/0008957     ,0.00,3900000,11276060257.29,19081200089570000008,
1267,12/08/2019,08:34:57,12/08/2019,08:34:57,0247 UKT 1801617286 0819/0006645        ,0.00,10300000,11286360257.29,19081200066450000020,
1268,12/08/2019,08:36:12,12/08/2019,08:36:12,0247 UKT 1939219014944 0819/0009746     ,0.00,1000000,11287360257.29,19081200097460000004,
1269,12/08/2019,08:37:08,12/08/2019,08:37:08,0247 UKT 1939219008349 0819/0006459     ,0.00,1000000,11288360257.29,19081200064590000012,
1270,12/08/2019,08:37:18,12/08/2019,08:37:18,0247 UKT 1939219010901 0819/0008594     ,0.00,7400000,11295760257.29,19081200085940000006,
1271,12/08/2019,08:38:28,12/08/2019,08:38:28,0247 SPU 1939219008349 0819/0006459     ,0.00,750000,11296510257.29,19081200064590000014,
1272,12/08/2019,08:39:22,12/08/2019,08:39:22,0247 UKT 1939219000413 0819/0018003     ,0.00,3000000,11299510257.29,19081200180030000013,
1273,12/08/2019,08:40:19,12/08/2019,08:40:19,0247 UKT 1939219012848 0819/0013066     ,0.00,4700000,11304210257.29,19081200130660000002,
1274,12/08/2019,08:40:25,12/08/2019,08:40:25,0247 UKT 1939219008052 0819/0008219     ,0.00,3000000,11307210257.29,19081200082190000021,
1275,12/08/2019,08:42:08,12/08/2019,08:42:08,0247 UKT 1939319000845 0819/0009772     ,0.00,3000000,11310210257.29,19081200097720000025,
1276,12/08/2019,08:42:10,12/08/2019,08:42:10,0247 UKT 1801617306 0819/0016439        ,0.00,8200000,11318410257.29,19081200164390000016,
1277,12/08/2019,08:42:34,12/08/2019,08:42:34,0247 SPU 1939319000845 0819/0009772     ,0.00,750000,11319160257.29,19081200097720000027,
1278,12/08/2019,08:42:52,12/08/2019,08:42:52,0247 UKT 1939119003960 0819/0012490     ,0.00,4000000,11323160257.29,19081200124900000015,
1279,12/08/2019,08:42:56,12/08/2019,08:42:56,0247 UKT 1939219002731 0819/0017974     ,0.00,3900000,11327060257.29,19081200179740000015,
1280,12/08/2019,08:43:38,12/08/2019,08:43:38,0247 UKT 1306617015 0819/0012486        ,0.00,1000000,11328060257.29,19081200124860000005,
1281,12/08/2019,08:44:05,12/08/2019,08:44:05,0247 UKT 1601617216 0819/0013055        ,0.00,4700000,11332760257.29,19081200130550000032,
1282,12/08/2019,08:45:25,12/08/2019,08:45:25,0247 UKT 1939119003439 0819/0016671     ,0.00,4500000,11337260257.29,19081200166710000010,
1283,12/08/2019,08:46:30,12/08/2019,08:46:30,0247 UKT 1939219004522 0819/0012490     ,0.00,7200000,11344460257.29,19081200124900000017,
1284,12/08/2019,08:46:50,12/08/2019,08:46:50,0247 UKT 1939219002449 0819/0008219     ,0.00,3000000,11347460257.29,19081200082190000023,
1285,12/08/2019,08:47:03,12/08/2019,08:47:03,0247 SPU 1939219002449 0819/0008219     ,0.00,750000,11348210257.29,19081200082190000025,
1286,12/08/2019,08:47:07,12/08/2019,08:47:07,0247 SPU 1939119001906 0819/0007248     ,0.00,750000,11348960257.29,19081200072480000016,
1287,12/08/2019,08:47:30,12/08/2019,08:47:30,0247 UKT 1939119001906 0819/0007248     ,0.00,4000000,11352960257.29,19081200072480000018,
1288,12/08/2019,08:47:44,12/08/2019,08:47:44,0247 SPU 1939219004522 0819/0012490     ,0.00,3000000,11355960257.29,19081200124900000019,
1289,12/08/2019,08:48:30,12/08/2019,08:48:30,0247 UKT 1939219006497 0819/0012479     ,0.00,6700000,11362660257.29,19081200124790000005,
1290,12/08/2019,08:48:34,12/08/2019,08:48:34,0247 SPU 1939119003439 0819/0016671     ,0.00,750000,11363410257.29,19081200166710000012,
1291,12/08/2019,08:48:35,12/08/2019,08:48:35,0247 UKT 1939219002942 0819/0008219     ,0.00,3000000,11366410257.29,19081200082190000028,
1292,12/08/2019,08:48:39,12/08/2019,08:48:39,0247 UKT 1304617047 0819/0012249        ,0.00,3950000,11370360257.29,19081200122490000009,
1293,12/08/2019,08:49:16,12/08/2019,08:49:16,0247 UKT 1211617044 0819/0013066        ,0.00,1000000,11371360257.29,19081200130660000004,
1294,12/08/2019,08:50:08,12/08/2019,08:50:08,0247 UKT 1939219009165 0819/0009748     ,0.00,4500000,11375860257.29,19081200097480000004,
1295,12/08/2019,08:51:17,12/08/2019,08:51:17,0247 UKT 1939319000609 0819/0017997     ,0.00,6200000,11382060257.29,19081200179970000026,
1296,12/08/2019,08:51:46,12/08/2019,08:51:46,0247 UKT 1939219008773 0819/0010972     ,0.00,3900000,11385960257.29,19081200109720000022,
1297,12/08/2019,08:52:12,12/08/2019,08:52:12,0247 UKT 1208617011 0819/0011829        ,0.00,4500000,11390460257.29,19081200118290000008,
1298,12/08/2019,08:52:32,12/08/2019,08:52:32,0247 SPU 1939219008773 0819/0010972     ,0.00,750000,11391210257.29,19081200109720000024,
1299,12/08/2019,08:55:48,12/08/2019,08:55:48,0247 UKT 1314618020 0819/0012247        ,0.00,4000000,11395210257.29,19081200122470000026,
1300,12/08/2019,08:56:12,12/08/2019,08:56:12,0247 UKT 1601617170 0819/0007168        ,0.00,4000000,11399210257.29,19081200071680000020,
1301,12/08/2019,08:57:58,12/08/2019,08:57:58,0247 UKT 1601618063 0819/0012490        ,0.00,2700000,11401910257.29,19081200124900000021,
1302,12/08/2019,08:58:51,12/08/2019,08:58:51,0247 UKT 1939119002871 0819/0016672     ,0.00,4150000,11406060257.29,19081200166720000028,
1303,12/08/2019,08:59:16,12/08/2019,08:59:16,0247 UKT 1939219009342 0819/0008237     ,0.00,5300000,11411360257.29,19081200082370000006,
1304,12/08/2019,08:59:17,12/08/2019,08:59:17,0247 SPU 1939119002871 0819/0016672     ,0.00,2000000,11413360257.29,19081200166720000031,
1305,12/08/2019,09:01:41,12/08/2019,09:01:41,0247 UKT 1939319000802 0819/0008281     ,0.00,4000000,11417360257.29,19081200082810000008,
1306,12/08/2019,09:02:49,12/08/2019,09:02:49,0247 UKT 1939219007953 0819/0008219     ,0.00,1000000,11418360257.29,19081200082190000030,
1307,12/08/2019,09:02:55,12/08/2019,09:02:55,0247 UKT 1939219014192 0819/0012239     ,0.00,6900000,11425260257.29,19081200122390000009,
1308,12/08/2019,09:03:25,12/08/2019,09:03:25,0247 SPU 1939219014192 0819/0012239     ,0.00,750000,11426010257.29,19081200122390000011,
1309,12/08/2019,09:04:19,12/08/2019,09:04:19,0247 UKT 1939219005826 0819/0008219     ,0.00,3900000,11429910257.29,19081200082190000032,
1310,12/08/2019,09:04:47,12/08/2019,09:04:47,0247 SPU 1939219000937 0819/0008244     ,0.00,1000000,11430910257.29,19081200082440000011,
1311,12/08/2019,09:05:09,12/08/2019,09:05:09,0247 UKT 1939219005989 0819/0008219     ,0.00,3000000,11433910257.29,19081200082190000034,
1312,12/08/2019,09:05:14,12/08/2019,09:05:14,0247 UKT 1939219000937 0819/0008244     ,0.00,7600000,11441510257.29,19081200082440000013,
1313,12/08/2019,09:06:39,12/08/2019,09:06:39,0247 UKT 1302618022 0819/0007367        ,0.00,6000000,11447510257.29,19081200073670000009,
1314,12/08/2019,09:08:13,12/08/2019,09:08:13,0247 UKT 1307617009 0819/0016660        ,0.00,4150000,11451660257.29,19081200166600000016,
1315,12/08/2019,09:09:43,12/08/2019,09:09:43,0247 UKT 1939219007444 0819/0010971     ,0.00,1000000,11452660257.29,19081200109710000002,
1316,12/08/2019,09:09:48,12/08/2019,09:09:48,0247 UKT 1107617216 0819/0008289        ,0.00,3900000,11456560257.29,19081200082890000026,
1317,12/08/2019,09:10:10,12/08/2019,09:10:10,0247 UKT 1302617005 0819/0016993        ,0.00,7000000,11463560257.29,19081200169930000028,
1318,12/08/2019,09:10:16,12/08/2019,09:10:16,0247 UKT 1939219003140 0819/0008219     ,0.00,1000000,11464560257.29,19081200082190000036,
1319,12/08/2019,09:11:33,12/08/2019,09:11:33,0247 UKT 1939219015618 0819/0013482     ,0.00,4000000,11468560257.29,19081200134820000006,
1320,12/08/2019,09:11:52,12/08/2019,09:11:52,0247 SPU 1939219008521 0819/0010446     ,0.00,750000,11469310257.29,19081200104460000004,
1321,12/08/2019,09:12:03,12/08/2019,09:12:03,0247 UKT 1939219003606 0819/0016623     ,0.00,10300000,11479610257.29,19081200166230000009,
1322,12/08/2019,09:12:21,12/08/2019,09:12:21,0247 UKT 1939219008521 0819/0010446     ,0.00,5300000,11484910257.29,19081200104460000006,
1323,12/08/2019,09:12:23,12/08/2019,09:12:23,0247 SPU 1939219005026 0819/0018000     ,0.00,750000,11485660257.29,19081200180000000009,
1324,12/08/2019,09:12:44,12/08/2019,09:12:44,0247 SPU 1939219003606 0819/0016623     ,0.00,20000000,11505660257.29,19081200166230000011,
1325,12/08/2019,09:12:47,12/08/2019,09:12:47,0247 UKT 1939219005026 0819/0018000     ,0.00,1000000,11506660257.29,19081200180000000011,
1326,12/08/2019,09:12:52,12/08/2019,09:12:52,0247 UKT 1939119000440 0819/0012485     ,0.00,6200000,11512860257.29,19081200124850000010,
1327,12/08/2019,09:14:01,12/08/2019,09:14:01,0247 UKT 1801617169 0819/0007367        ,0.00,8200000,11521060257.29,19081200073670000017,
1328,12/08/2019,09:14:41,12/08/2019,09:14:41,0247 UKT 1939219000429 0819/0016436     ,0.00,5300000,11526360257.29,19081200164360000039,
1329,12/08/2019,09:15:02,12/08/2019,09:15:02,0247 SPU 1939219000429 0819/0016436     ,0.00,750000,11527110257.29,19081200164360000041,
1330,12/08/2019,09:15:35,12/08/2019,09:15:35,0247 UKT                                ,0.00,5100000,11532210257.29,19081299171010458522,
1331,12/08/2019,09:16:16,12/08/2019,09:16:16,0247 UKT 1939119002191 0819/0008586     ,0.00,4000000,11536210257.29,19081200085860000016,
1332,12/08/2019,09:16:36,12/08/2019,09:16:36,0247 SPU 1939119002191 0819/0008586     ,0.00,10000000,11546210257.29,19081200085860000018,
1333,12/08/2019,09:17:10,12/08/2019,09:17:10,0247 UKT 1939219005725 0819/0010761     ,0.00,5600000,11551810257.29,19081200107610000005,
1334,12/08/2019,09:17:21,12/08/2019,09:17:21,0247 UKT 1939219010032 0819/0016625     ,0.00,500000,11552310257.29,19081200166250000005,
1335,12/08/2019,09:18:03,12/08/2019,09:18:03,0247 UKT 1939219004988 0819/0018025     ,0.00,4500000,11556810257.29,19081200180250000006,
1336,12/08/2019,09:18:07,12/08/2019,09:18:07,0247 UKT 1801617011 0819/0016505        ,0.00,6200000,11563010257.29,19081200165050000010,
1337,12/08/2019,09:18:08,12/08/2019,09:18:08,0247 UKT 1107618112 0819/0008253        ,0.00,3000000,11566010257.29,19081200082530000005,
1338,12/08/2019,09:18:44,12/08/2019,09:18:44,0247 UKT 1939119002487 0819/0009772     ,0.00,7300000,11573310257.29,19081200097720000046,
1339,12/08/2019,09:19:28,12/08/2019,09:19:28,0247 UKT 1939219001395 0819/0008251     ,0.00,4500000,11577810257.29,19081200082510000038,
1340,12/08/2019,09:20:00,12/08/2019,09:20:00,0247 UKT 1939219013943 0819/0010971     ,0.00,3000000,11580810257.29,19081200109710000004,
1341,12/08/2019,09:20:24,12/08/2019,09:20:24,0247 SPU 1939219013943 0819/0010971     ,0.00,1000000,11581810257.29,19081200109710000006,
1342,12/08/2019,09:21:02,12/08/2019,09:21:02,0247 UKT 1939219014616 0819/0009593     ,0.00,500000,11582310257.29,19081200095930000007,
1343,12/08/2019,09:21:18,12/08/2019,09:21:18,0247 UKT 1104617113 0819/0008219        ,0.00,3000000,11585310257.29,19081200082190000039,
1344,12/08/2019,09:22:28,12/08/2019,09:22:28,0247 UKT 1939219006824 0819/0013447     ,0.00,1000000,11586310257.29,19081200134470000024,
1345,12/08/2019,09:22:44,12/08/2019,09:22:44,0247 UKT 1939119001610 0819/0007367     ,0.00,4650000,11590960257.29,19081200073670000019,
1346,12/08/2019,09:22:56,12/08/2019,09:22:56,0247 UKT 1939219014764 0819/0007222     ,0.00,5100000,11596060257.29,19081200072220000003,
1347,12/08/2019,09:23:13,12/08/2019,09:23:13,0247 UKT 1601617138 0819/0016663        ,0.00,2700000,11598760257.29,19081200166630000018,
1348,12/08/2019,09:23:36,12/08/2019,09:23:36,0247 UKT 1939219009543 0819/0008219     ,0.00,5300000,11604060257.29,19081200082190000041,
1349,12/08/2019,09:23:53,12/08/2019,09:23:53,0247 SPU 1939219009543 0819/0008219     ,0.00,750000,11604810257.29,19081200082190000043,
1350,12/08/2019,09:24:20,12/08/2019,09:24:20,0247 SPU 1939219014764 0819/0007222     ,0.00,1000000,11605810257.29,19081200072220000005,
1351,12/08/2019,09:25:01,12/08/2019,09:25:01,0247 UKT 1939119002953 0819/0007248     ,0.00,3800000,11609610257.29,19081200072480000024,
1352,12/08/2019,09:25:31,12/08/2019,09:25:31,0247 UKT 1939219011195 0819/0007900     ,0.00,5100000,11614710257.29,19081200079000000021,
1353,12/08/2019,09:25:55,12/08/2019,09:25:55,0247 UKT 1939219010542 0819/0007019     ,0.00,4600000,11619310257.29,19081200070190000021,
1354,12/08/2019,09:27:29,12/08/2019,09:27:29,0247 UKT 1939219008965 0819/0007248     ,0.00,7100000,11626410257.29,19081200072480000026,
1355,12/08/2019,09:27:46,12/08/2019,09:27:46,0247 UKT 1939219008936 0819/0012479     ,0.00,1000000,11627410257.29,19081200124790000013,
1356,12/08/2019,09:27:50,12/08/2019,09:27:50,0247 UKT 1205617054 0819/0017009        ,0.00,3900000,11631310257.29,19081200170090000017,
1357,12/08/2019,09:28:06,12/08/2019,09:28:06,0247 SPU 1939219008965 0819/0007248     ,0.00,1000000,11632310257.29,19081200072480000028,
1358,12/08/2019,09:28:44,12/08/2019,09:28:44,0247 SPU 1939219014312 0819/0013799     ,0.00,1500000,11633810257.29,19081200137990000048,
1359,12/08/2019,09:29:12,12/08/2019,09:29:12,0247 UKT 1939219014312 0819/0013799     ,0.00,6200000,11640010257.29,19081200137990000050,
1360,12/08/2019,09:31:02,12/08/2019,09:31:02,0247 UKT 1302617012 0819/0006168        ,0.00,6000000,11646010257.29,19081200061680000015,
1361,12/08/2019,09:31:34,12/08/2019,09:31:34,0247 UKT 1939219014847 0819/0008294     ,0.00,5800000,11651810257.29,19081200082940000045,
1362,12/08/2019,09:32:54,12/08/2019,09:32:54,0247 SPU 1939219001583 0819/0016717     ,0.00,10000000,11661810257.29,19081200167170000028,
1363,12/08/2019,09:33:14,12/08/2019,09:33:14,0247 UKT 1939319000713 0819/0007222     ,0.00,3000000,11664810257.29,19081200072220000008,
1364,12/08/2019,09:33:25,12/08/2019,09:33:25,0247 UKT 1939219001583 0819/0016717     ,0.00,8200000,11673010257.29,19081200167170000030,
1365,12/08/2019,09:33:47,12/08/2019,09:33:47,0247 UKT 1939219002030 0819/0008281     ,0.00,3000000,11676010257.29,19081200082810000018,
1366,12/08/2019,09:33:57,12/08/2019,09:33:57,0247 UKT 1939219005657 0819/0017966     ,0.00,3200000,11679210257.29,19081200179660000010,
1367,12/08/2019,09:34:29,12/08/2019,09:34:29,0247 SPU 1939319000713 0819/0007222     ,0.00,750000,11679960257.29,19081200072220000010,
1368,12/08/2019,09:35:23,12/08/2019,09:35:23,0247 UKT 1939319000704 0819/0016717     ,0.00,6200000,11686160257.29,19081200167170000032,
1369,12/08/2019,09:35:25,12/08/2019,09:35:25,0247 UKT 1939219014831 0819/0016490     ,0.00,6700000,11692860257.29,19081200164900000015,
1370,12/08/2019,09:35:56,12/08/2019,09:35:56,0247 SPU 1939219014831 0819/0016490     ,0.00,2000000,11694860257.29,19081200164900000017,
1371,12/08/2019,09:36:06,12/08/2019,09:36:06,0247 UKT 1939219017206 0819/0008219     ,0.00,4000000,11698860257.29,19081200082190000056,
1372,12/08/2019,09:36:08,12/08/2019,09:36:08,0247 UKT 1939219013322 0819/0010413     ,0.00,3000000,11701860257.29,19081200104130000012,
1373,12/08/2019,09:36:27,12/08/2019,09:36:27,0247 UKT 1801617114 0819/0010978        ,0.00,7200000,11709060257.29,19081200109780000030,
1374,12/08/2019,09:36:28,12/08/2019,09:36:28,0247 SPU 1939219017206 0819/0008219     ,0.00,1000000,11710060257.29,19081200082190000058,
1375,12/08/2019,09:37:05,12/08/2019,09:37:05,0247 UKT 1939219009984 0819/0016618     ,0.00,3900000,11713960257.29,19081200166180000009,
1376,12/08/2019,09:38:21,12/08/2019,09:38:21,0247 SPU 1939219004314 0819/0008574     ,0.00,1000000,11714960257.29,19081200085740000034,
1377,12/08/2019,09:38:44,12/08/2019,09:38:44,0247 UKT 1939219004314 0819/0008574     ,0.00,6500000,11721460257.29,19081200085740000036,
1378,12/08/2019,09:38:57,12/08/2019,09:38:57,0247 UKT 1939219012542 0819/0008219     ,0.00,5300000,11726760257.29,19081200082190000060,
1379,12/08/2019,09:39:09,12/08/2019,09:39:09,0247 UKT 1801617287 0819/0017783        ,0.00,6200000,11732960257.29,19081200177830000025,
1380,12/08/2019,09:39:32,12/08/2019,09:39:32,0247 SPU 1939219012542 0819/0008219     ,0.00,5000000,11737960257.29,19081200082190000062,
1381,12/08/2019,09:40:06,12/08/2019,09:40:06,0247 UKT 1939219010929 0819/0009593     ,0.00,5100000,11743060257.29,19081200095930000011,
1382,12/08/2019,09:40:59,12/08/2019,09:40:59,0247 UKT 1106617069 0819/0008246        ,0.00,3000000,11746060257.29,19081200082460000055,
1383,12/08/2019,09:41:19,12/08/2019,09:41:19,0247 UKT 1939119003498 0819/0008219     ,0.00,500000,11746560257.29,19081200082190000065,
1384,12/08/2019,09:42:33,12/08/2019,09:42:33,0247 UKT 1313617026 0819/0008219        ,0.00,4000000,11750560257.29,19081200082190000067,
1385,12/08/2019,09:44:04,12/08/2019,09:44:04,0247 UKT 1201617013 0819/0017017        ,0.00,4000000,11754560257.29,19081200170170000004,
1386,12/08/2019,09:44:16,12/08/2019,09:44:16,0247 UKT 1939219009286 0819/0008220     ,0.00,3900000,11758460257.29,19081200082200000024,
1387,12/08/2019,09:44:28,12/08/2019,09:44:28,0247 UKT 1939119003990 0819/0008219     ,0.00,4000000,11762460257.29,19081200082190000069,
1388,12/08/2019,09:44:47,12/08/2019,09:44:47,0247 SPU 1939119003990 0819/0008219     ,0.00,750000,11763210257.29,19081200082190000071,
1389,12/08/2019,09:50:58,12/08/2019,09:50:58,0247 UKT 1939219014237 0819/0007759     ,0.00,3000000,11766210257.29,19081200077590000071,
1390,12/08/2019,09:51:02,12/08/2019,09:51:02,0247 UKT 1939319000527 0819/0013482     ,0.00,4000000,11770210257.29,19081200134820000016,
1391,12/08/2019,09:51:26,12/08/2019,09:51:26,0247 SPU 1939219014237 0819/0007759     ,0.00,1000000,11771210257.29,19081200077590000073,
1392,12/08/2019,09:51:27,12/08/2019,09:51:27,0247 UKT 1801617026 0819/0008219        ,0.00,8200000,11779410257.29,19081200082190000079,
1393,12/08/2019,09:51:47,12/08/2019,09:51:47,0247 UKT 1939119003455 0819/0018029     ,0.00,6000000,11785410257.29,19081200180290000014,
1394,12/08/2019,09:52:02,12/08/2019,09:52:02,0247 UKT 1939119001045 0819/0009761     ,0.00,6200000,11791610257.29,19081200097610000110,
1395,12/08/2019,09:52:38,12/08/2019,09:52:38,0247 SPU 1939119003455 0819/0018029     ,0.00,750000,11792360257.29,19081200180290000016,
1396,12/08/2019,09:53:28,12/08/2019,09:53:28,0247 SPU 1939219001400 0819/0008219     ,0.00,1500000,11793860257.29,19081200082190000081,
1397,12/08/2019,09:54:30,12/08/2019,09:54:30,0247 UKT 1939219006907 0819/0013505     ,0.00,8200000,11802060257.29,19081200135050000080,
1398,12/08/2019,09:54:48,12/08/2019,09:54:48,0247 UKT 1939219009651 0819/0008219     ,0.00,8200000,11810260257.29,19081200082190000083,
1399,12/08/2019,09:54:52,12/08/2019,09:54:52,0247 UKT 1939219004725 0819/0007346     ,0.00,5100000,11815360257.29,19081200073460000019,
1400,12/08/2019,09:55:11,12/08/2019,09:55:11,0247 UKT 1305617035 0819/0017977        ,0.00,6200000,11821560257.29,19081200179770000031,
1401,12/08/2019,09:56:27,12/08/2019,09:56:27,0247 SPU 1939219006907 0819/0013505     ,0.00,750000,11822310257.29,19081200135050000083,
1402,12/08/2019,09:59:00,12/08/2019,09:59:00,0247 UKT 1939219015655 0819/0009613     ,0.00,1000000,11823310257.29,19081200096130000061,
1403,12/08/2019,09:59:20,12/08/2019,09:59:20,0247 UKT 1939219012994 0819/0008219     ,0.00,3700000,11827010257.29,19081200082190000085,
1404,12/08/2019,09:59:40,12/08/2019,09:59:40,0247 SPU 1939219012994 0819/0008219     ,0.00,1000000,11828010257.29,19081200082190000087,
1405,12/08/2019,10:00:06,12/08/2019,10:00:06,0247 UKT 1302618018 0819/0012490        ,0.00,7000000,11835010257.29,19081200124900000045,
1406,12/08/2019,10:00:12,12/08/2019,10:00:12,0247 UKT 1939219006100 0819/0010956     ,0.00,3000000,11838010257.29,19081200109560000078,
1407,12/08/2019,10:01:17,12/08/2019,10:01:17,0247 UKT 1939119002157 0819/0013049     ,0.00,1000000,11839010257.29,19081200130490000037,
1408,12/08/2019,10:01:38,12/08/2019,10:01:38,0247 UKT 1106618017 0819/0013497        ,0.00,3900000,11842910257.29,19081200134970000057,
1409,12/08/2019,10:01:54,12/08/2019,10:01:54,0247 UKT 1939219008684 0819/0018029     ,0.00,3900000,11846810257.29,19081200180290000022,
1410,12/08/2019,10:03:30,12/08/2019,10:03:30,0247 UKT 1939219008505 0819/0017003     ,0.00,4600000,11851410257.29,19081200170030000016,
1411,12/08/2019,10:03:34,12/08/2019,10:03:34,0247 UKT 1939219015277 0819/0008219     ,0.00,5900000,11857310257.29,19081200082190000089,
1412,12/08/2019,10:03:47,12/08/2019,10:03:47,0247 UKT 1313617002 0819/0011952        ,0.00,4000000,11861310257.29,19081200119520000062,
1413,12/08/2019,10:03:54,12/08/2019,10:03:54,0247 SPU 1939219015277 0819/0008219     ,0.00,5000000,11866310257.29,19081200082190000091,
1414,12/08/2019,10:04:47,12/08/2019,10:04:47,0247 SPU 1939219016928 0819/0016716     ,0.00,750000,11867060257.29,19081200167160000014,
1415,12/08/2019,10:04:54,12/08/2019,10:04:54,0247 UKT 1939219000699 0819/0013446     ,0.00,5400000,11872460257.29,19081200134460000036,
1416,12/08/2019,10:05:35,12/08/2019,10:05:35,0247 UKT 1939219016928 0819/0016716     ,0.00,4000000,11876460257.29,19081200167160000016,
1417,12/08/2019,10:08:00,12/08/2019,10:08:00,0247 UKT 1939119001569 0819/0017996     ,0.00,4000000,11880460257.29,19081200179960000029,
1418,12/08/2019,10:08:02,12/08/2019,10:08:02,0247 UKT 1939219007042 0819/0013446     ,0.00,4600000,11885060257.29,19081200134460000039,
1419,12/08/2019,10:08:18,12/08/2019,10:08:18,0247 UKT 1939219016304 0819/0017995     ,0.00,3900000,11888960257.29,19081200179950000014,
1420,12/08/2019,10:09:00,12/08/2019,10:09:00,0247 UKT 1939119002976 0819/0016661     ,0.00,3950000,11892910257.29,19081200166610000043,
1421,12/08/2019,10:09:07,12/08/2019,10:09:07,0247 UKT 1939219012610 0819/0008298     ,0.00,6400000,11899310257.29,19081200082980000007,
1422,12/08/2019,10:09:34,12/08/2019,10:09:34,0247 UKT 1939219015822 0819/0011802     ,0.00,4000000,11903310257.29,19081200118020000018,
1423,12/08/2019,10:09:44,12/08/2019,10:09:44,0247 UKT 1015/1939219001605 0819/0009613,0.00,6700000,11910010257.29,19081200096130000086,
1424,12/08/2019,10:10:20,12/08/2019,10:10:20,0247 SPU 1939219015822 0819/0011802     ,0.00,1000000,11911010257.29,19081200118020000020,
1425,12/08/2019,10:10:20,12/08/2019,10:10:20,0247 UKT 1107617194 0819/0018000        ,0.00,5100000,11916110257.29,19081200180000000019,
1426,12/08/2019,10:12:58,12/08/2019,10:12:58,0247 SPU 1939219016875 0819/0012937     ,0.00,5000000,11921110257.29,19081200129370000006,
1427,12/08/2019,10:13:26,12/08/2019,10:13:26,0247 UKT 1939219016875 0819/0012937     ,0.00,5800000,11926910257.29,19081200129370000008,
1428,12/08/2019,10:13:39,12/08/2019,10:13:39,0247 UKT 1939119002505 0819/0008219     ,0.00,4000000,11930910257.29,19081200082190000093,
1429,12/08/2019,10:14:21,12/08/2019,10:14:21,0247 SPU 1939119002505 0819/0008219     ,0.00,750000,11931660257.29,19081200082190000096,
1430,12/08/2019,10:15:19,12/08/2019,10:15:19,0247 UKT 1939119002573 0819/0010978     ,0.00,1000000,11932660257.29,19081200109780000038,
1431,12/08/2019,10:15:47,12/08/2019,10:15:47,0247 UKT 1939119001508 0819/0011932     ,0.00,3950000,11936610257.29,19081200119320000018,
1432,12/08/2019,10:16:59,12/08/2019,10:16:59,0247 UKT 1939219010485 0819/0010443     ,0.00,5100000,11941710257.29,19081200104430000036,
1433,12/08/2019,10:17:27,12/08/2019,10:17:27,0247 UKT 1939219010925 0819/0010960     ,0.00,3000000,11944710257.29,19081200109600000094,
1434,12/08/2019,10:18:06,12/08/2019,10:18:06,0247 UKT 1308618015 0819/0008219        ,0.00,5250000,11949960257.29,19081200082190000098,
1435,12/08/2019,10:19:02,12/08/2019,10:19:02,0247 UKT 1939219004125 0819/0013066     ,0.00,6500000,11956460257.29,19081200130660000033,
1436,12/08/2019,10:19:29,12/08/2019,10:19:29,0247 UKT 1205617109 0819/0008219        ,0.00,5900000,11962360257.29,19081200082190000100,
1437,12/08/2019,10:19:36,12/08/2019,10:19:36,0247 SPU 1939219004125 0819/0013066     ,0.00,2000000,11964360257.29,19081200130660000035,
1438,12/08/2019,10:19:37,12/08/2019,10:19:37,0247 UKT 1939119001748 0819/0013799     ,0.00,6200000,11970560257.29,19081200137990000070,
1439,12/08/2019,10:21:06,12/08/2019,10:21:06,0247 SPU 1939119001748 0819/0013799     ,0.00,1000000,11971560257.29,19081200137990000072,
1440,12/08/2019,10:21:37,12/08/2019,10:21:37,0247 UKT 1939119001963 0819/0017963     ,0.00,4000000,11975560257.29,19081200179630000011,
1441,12/08/2019,10:21:39,12/08/2019,10:21:39,0247 UKT 1308618068 0819/0009593        ,0.00,4150000,11979710257.29,19081200095930000019,
1442,12/08/2019,10:23:02,12/08/2019,10:23:02,0247 UKT 1602618025 0819/0016689        ,0.00,4700000,11984410257.29,19081200166890000105,
1443,12/08/2019,10:23:35,12/08/2019,10:23:35,0247 UKT 1801618049 0819/0013482        ,0.00,10300000,11994710257.29,19081200134820000020,
1444,12/08/2019,10:24:16,12/08/2019,10:24:16,0247 UKT 1304618065 0819/0017789        ,0.00,5200000,11999910257.29,19081200177890000066,
1445,12/08/2019,10:24:50,12/08/2019,10:24:50,0247 UKT 1939119003410 0819/0013055     ,0.00,9000000,12008910257.29,19081200130550000117,
1446,12/08/2019,10:24:56,12/08/2019,10:24:56,0247 SPU 1939219004394 0819/0008219     ,0.00,5000000,12013910257.29,19081200082190000102,
1447,12/08/2019,10:25:08,12/08/2019,10:25:08,0247 SPU 1939219003175 0819/0010462     ,0.00,3000000,12016910257.29,19081200104620000009,
1448,12/08/2019,10:25:37,12/08/2019,10:25:37,0247 UKT 1314617010 0819/0010956        ,0.00,4000000,12020910257.29,19081200109560000098,
1449,12/08/2019,10:25:51,12/08/2019,10:25:51,0247 UKT 1801618009 0819/0007897        ,0.00,4000000,12024910257.29,19081200078970000014,
1450,12/08/2019,10:27:23,12/08/2019,10:27:23,0247 UKT 1939119000628 0819/0008219     ,0.00,4150000,12029060257.29,19081200082190000104,
1451,12/08/2019,10:29:05,12/08/2019,10:29:05,0247 UKT 1302617019 0819/0008219        ,0.00,9000000,12038060257.29,19081200082190000106,
1452,12/08/2019,10:29:08,12/08/2019,10:29:08,0247 UKT                                ,0.00,5200000,12043260257.29,19081299275020045410,
1453,12/08/2019,10:30:24,12/08/2019,10:30:24,0247 UKT 1305618007 0819/0011952        ,0.00,4000000,12047260257.29,19081200119520000072,
1454,12/08/2019,10:30:30,12/08/2019,10:30:30,0247 UKT 1939119002392 0819/0013678     ,0.00,4150000,12051410257.29,19081200136780000056,
1455,12/08/2019,10:30:34,12/08/2019,10:30:34,0247 UKT 1939219012701 0819/0012937     ,0.00,3000000,12054410257.29,19081200129370000010,
1456,12/08/2019,10:31:00,12/08/2019,10:31:00,0247 UKT 1304617063 0819/0016671        ,0.00,5200000,12059610257.29,19081200166710000039,
1457,12/08/2019,10:31:13,12/08/2019,10:31:13,0247 SPU 1939119002392 0819/0013678     ,0.00,3000000,12062610257.29,19081200136780000058,
1458,12/08/2019,10:31:14,12/08/2019,10:31:14,0247 UKT 1939219009847 0819/0008219     ,0.00,5900000,12068510257.29,19081200082190000108,
1459,12/08/2019,10:31:58,12/08/2019,10:31:58,0247 UKT 1939219004908 0819/0018000     ,0.00,3000000,12071510257.29,19081200180000000021,
1460,12/08/2019,10:33:19,12/08/2019,10:33:19,0247 UKT 1801617105 0819/0008219        ,0.00,10300000,12081810257.29,19081200082190000110,
1461,12/08/2019,10:35:09,12/08/2019,10:35:09,0247 UKT 1939219003315 0819/0008219     ,0.00,4300000,12086110257.29,19081200082190000112,
1462,12/08/2019,10:35:24,12/08/2019,10:35:24,0247 SPU 1939219003891 0819/0016997     ,0.00,20000000,12106110257.29,19081200169970000018,
1463,12/08/2019,10:35:53,12/08/2019,10:35:53,0247 UKT 1939219003891 0819/0016997     ,0.00,6100000,12112210257.29,19081200169970000020,
1464,12/08/2019,10:36:09,12/08/2019,10:36:09,0247 UKT 1939119001912 0819/0012490     ,0.00,1000000,12113210257.29,19081200124900000053,
1465,12/08/2019,10:36:22,12/08/2019,10:36:22,0247 UKT 1603617023 0819/0008594        ,0.00,4300000,12117510257.29,19081200085940000029,
1466,12/08/2019,10:36:46,12/08/2019,10:36:46,0247 UKT 1939219002099 0819/0017770     ,0.00,8200000,12125710257.29,19081200177700000125,
1467,12/08/2019,10:36:51,12/08/2019,10:36:51,0247 UKT 1801617181 0819/0011814        ,0.00,7200000,12132910257.29,19081200118140000020,
1468,12/08/2019,10:36:52,12/08/2019,10:36:52,0247 UKT 1102618049 0819/0016490        ,0.00,10200000,12143110257.29,19081200164900000050,
1469,12/08/2019,10:36:53,12/08/2019,10:36:53,0247 UKT 1939219012194 0819/0006789     ,0.00,3000000,12146110257.29,19081200067890000005,
1470,12/08/2019,10:37:01,12/08/2019,10:37:01,0247 UKT 1602617218 0819/0011831        ,0.00,500000,12146610257.29,19081200118310000022,
1471,12/08/2019,10:37:09,12/08/2019,10:37:09,0247 UKT 1939219013370 0819/0008219     ,0.00,4500000,12151110257.29,19081200082190000114,
1472,12/08/2019,10:37:11,12/08/2019,10:37:11,0247 UKT 1939219010273 0819/0016533     ,0.00,500000,12151610257.29,19081200165330000034,
1473,12/08/2019,10:37:12,12/08/2019,10:37:12,0247 UKT 1801617274 0819/0007887        ,0.00,4000000,12155610257.29,19081200078870000056,
1474,12/08/2019,10:37:29,12/08/2019,10:37:29,0247 SPU 1939219013370 0819/0008219     ,0.00,750000,12156360257.29,19081200082190000116,
1475,12/08/2019,10:38:20,12/08/2019,10:38:20,0247 UKT 1939219009945 0819/0009593     ,0.00,3700000,12160060257.29,19081200095930000023,
1476,12/08/2019,10:40:31,12/08/2019,10:40:31,0247 SPU 1939119001587 0819/0008219     ,0.00,750000,12160810257.29,19081200082190000118,
1477,12/08/2019,10:40:51,12/08/2019,10:40:51,0247 UKT 1303617068 0819/0008294        ,0.00,6200000,12167010257.29,19081200082940000112,
1478,12/08/2019,10:41:11,12/08/2019,10:41:11,0247 UKT 1209617037 0819/0011952        ,0.00,5200000,12172210257.29,19081200119520000076,
1479,12/08/2019,10:41:28,12/08/2019,10:41:28,0247 UKT 1939219013375 0819/0017977     ,0.00,3900000,12176110257.29,19081200179770000066,
1480,12/08/2019,10:42:10,12/08/2019,10:42:10,0247 UKT 1939119000084 0819/0007367     ,0.00,6200000,12182310257.29,19081200073670000034,
1481,12/08/2019,10:42:30,12/08/2019,10:42:30,0247 UKT 1213617004 0819/0016630        ,0.00,3700000,12186010257.29,19081200166300000017,
1482,12/08/2019,10:42:50,12/08/2019,10:42:50,0247 UKT 1939219010778 0819/0012240     ,0.00,4700000,12190710257.29,19081200122400000029,
1483,12/08/2019,10:42:59,12/08/2019,10:42:59,0247 UKT 1302618021 0819/0008957        ,0.00,3800000,12194510257.29,19081200089570000028,
1484,12/08/2019,10:43:07,12/08/2019,10:43:07,0247 UKT 1104617085 0819/0018015        ,0.00,500000,12195010257.29,19081200180150000022,
1485,12/08/2019,10:43:43,12/08/2019,10:43:43,0247 UKT 1939219010898 0819/0013204     ,0.00,1000000,12196010257.29,19081200132040000083,
1486,12/08/2019,10:43:51,12/08/2019,10:43:51,0247 SPU 1939119000084 0819/0007367     ,0.00,750000,12196760257.29,19081200073670000036,
1487,12/08/2019,10:43:53,12/08/2019,10:43:53,0247 UKT 1801617184 0819/0016529        ,0.00,8200000,12204960257.29,19081200165290000079,
1488,12/08/2019,10:44:03,12/08/2019,10:44:03,0247 SPU 1939219010898 0819/0013204     ,0.00,750000,12205710257.29,19081200132040000085,
1489,12/08/2019,10:44:09,12/08/2019,10:44:09,0247 UKT 1102617033 0819/0007012        ,0.00,6400000,12212110257.29,19081200070120000021,
1490,12/08/2019,10:46:19,12/08/2019,10:46:19,0247 UKT 1105618066 0819/0008219        ,0.00,5100000,12217210257.29,19081200082190000120,
1491,12/08/2019,10:46:35,12/08/2019,10:46:35,0247 UKT 1306618020 0819/0017770        ,0.00,4500000,12221710257.29,19081200177700000132,
1492,12/08/2019,10:46:45,12/08/2019,10:46:45,0247 SPU 1939219012390 0819/0007168     ,0.00,750000,12222460257.29,19081200071680000071,
1493,12/08/2019,10:48:19,12/08/2019,10:48:19,0247 UKT 1939219012390 0819/0007168     ,0.00,5900000,12228360257.29,19081200071680000073,
1494,12/08/2019,10:48:26,12/08/2019,10:48:26,0247 UKT 1939219004839 0819/0008219     ,0.00,4700000,12233060257.29,19081200082190000122,
1495,12/08/2019,10:49:20,12/08/2019,10:49:20,0247 UKT 1601617149 0819/0016715        ,0.00,4000000,12237060257.29,19081200167150000038,
1496,12/08/2019,10:50:05,12/08/2019,10:50:05,0247 SPU 1939219010186 0819/0017001     ,0.00,750000,12237810257.29,19081200170010000035,
1497,12/08/2019,10:50:41,12/08/2019,10:50:41,0247 UKT 1939219015032 0819/0009659     ,0.00,5300000,12243110257.29,19081200096590000057,
1498,12/08/2019,10:51:18,12/08/2019,10:51:18,0247 UKT 1939219001254 0819/0008219     ,0.00,5600000,12248710257.29,19081200082190000124,
1499,12/08/2019,10:51:47,12/08/2019,10:51:47,0247 UKT 1939319000951 0819/0006459     ,0.00,8200000,12256910257.29,19081200064590000071,
1500,12/08/2019,10:52:17,12/08/2019,10:52:17,0247 UKT 1305618005 0819/0009593        ,0.00,4000000,12260910257.29,19081200095930000027,
1501,12/08/2019,10:53:20,12/08/2019,10:53:20,0247 UKT 1307617001 0819/0007348        ,0.00,4150000,12265060257.29,19081200073480000043,
1502,12/08/2019,10:54:07,12/08/2019,10:54:07,0247 UKT                                ,0.00,4700000,12269760257.29,19081299119010252977,
1503,12/08/2019,10:54:32,12/08/2019,10:54:32,0247 UKT 1939219014730 0819/0008219     ,0.00,6700000,12276460257.29,19081200082190000127,
1504,12/08/2019,10:55:18,12/08/2019,10:55:18,0247 SPU 1939119003006 0819/0010761     ,0.00,750000,12277210257.29,19081200107610000080,
1505,12/08/2019,10:55:24,12/08/2019,10:55:24,0247 UKT 1208617016 0819/0012490        ,0.00,4500000,12281710257.29,19081200124900000063,
1506,12/08/2019,10:55:33,12/08/2019,10:55:33,0247 UKT 1939219002301 0819/0016436     ,0.00,4500000,12286210257.29,19081200164360000074,
1507,12/08/2019,10:55:49,12/08/2019,10:55:49,0247 UKT 1801618163 0819/0008219        ,0.00,7200000,12293410257.29,19081200082190000129,
1508,12/08/2019,10:55:51,12/08/2019,10:55:51,0247 UKT 1939119003006 0819/0010761     ,0.00,6000000,12299410257.29,19081200107610000082,
1509,12/08/2019,10:57:48,12/08/2019,10:57:48,0247 UKT 1939219001804 0819/0008219     ,0.00,3000000,12302410257.29,19081200082190000131,
1510,12/08/2019,10:57:58,12/08/2019,10:57:58,0247 UKT 1106617034 0819/0016534        ,0.00,4500000,12306910257.29,19081200165340000008,
1511,12/08/2019,10:58:42,12/08/2019,10:58:42,0247 UKT 1939119002451 0819/0008207     ,0.00,3800000,12310710257.29,19081200082070000161,
1512,12/08/2019,10:58:52,12/08/2019,10:58:52,0247 UKT 1104617014 0819/0008574        ,0.00,1000000,12311710257.29,19081200085740000057,
1513,12/08/2019,10:59:26,12/08/2019,10:59:26,0247 UKT 1601617125 0819/0008587        ,0.00,6800000,12318510257.29,19081200085870000014,
1514,12/08/2019,10:59:35,12/08/2019,10:59:35,0247 SPU 1939119002451 0819/0008207     ,0.00,1000000,12319510257.29,19081200082070000163,
1515,12/08/2019,11:00:54,12/08/2019,11:00:54,0247 UKT 1939219007514 0819/0017989     ,0.00,5300000,12324810257.29,19081200179890000026,
1516,12/08/2019,11:01:31,12/08/2019,11:01:31,0247 UKT 1939119002246 0819/0018007     ,0.00,6000000,12330810257.29,19081200180070000030,
1517,12/08/2019,11:01:33,12/08/2019,11:01:33,0247 UKT 1205617011 0819/0016991        ,0.00,3900000,12334710257.29,19081200169910000029,
1518,12/08/2019,11:01:35,12/08/2019,11:01:35,0247 UKT 1107617238 0819/0012923        ,0.00,6400000,12341110257.29,19081200129230000053,
1519,12/08/2019,11:02:04,12/08/2019,11:02:04,0247 UKT 1939219000798 0819/0016661     ,0.00,1000000,12342110257.29,19081200166610000073,
1520,12/08/2019,11:02:06,12/08/2019,11:02:06,0247 UKT 1939319000830 0819/0018006     ,0.00,3900000,12346010257.29,19081200180060000047,
1521,12/08/2019,11:02:53,12/08/2019,11:02:53,0247 UKT 1801617223 0819/0016441        ,0.00,8200000,12354210257.29,19081200164410000061,
1522,12/08/2019,11:04:03,12/08/2019,11:04:03,0247 UKT 1939119000686 0819/0016441     ,0.00,6200000,12360410257.29,19081200164410000063,
1523,12/08/2019,11:05:42,12/08/2019,11:05:42,0247 UKT 1939319000300 0819/0008574     ,0.00,3200000,12363610257.29,19081200085740000063,
1524,12/08/2019,11:05:43,12/08/2019,11:05:43,0247 UKT 1939219009412 0819/0018024     ,0.00,8200000,12371810257.29,19081200180240000024,
1525,12/08/2019,11:06:00,12/08/2019,11:06:00,0247 UKT 1209618004 0819/0009593        ,0.00,4500000,12376310257.29,19081200095930000031,
1526,12/08/2019,11:06:24,12/08/2019,11:06:24,0247 UKT 1939119004061 0819/0013466     ,0.00,8000000,12384310257.29,19081200134660000043,
1527,12/08/2019,11:06:56,12/08/2019,11:06:56,0247 SPU 1939119004061 0819/0013466     ,0.00,10000000,12394310257.29,19081200134660000045,
1528,12/08/2019,11:08:52,12/08/2019,11:08:52,0247 UKT 1939219016170 0819/0008219     ,0.00,3000000,12397310257.29,19081200082190000135,
1529,12/08/2019,11:09:10,12/08/2019,11:09:10,0247 SPU 1939219016170 0819/0008219     ,0.00,750000,12398060257.29,19081200082190000137,
1530,12/08/2019,11:10:16,12/08/2019,11:10:16,0247 UKT 1314617002 0819/0009754        ,0.00,4000000,12402060257.29,19081200097540000048,
1531,12/08/2019,11:10:29,12/08/2019,11:10:29,0247 UKT 1209618023 0819/0008937        ,0.00,6700000,12408760257.29,19081200089370000017,
1532,12/08/2019,11:11:20,12/08/2019,11:11:20,0247 UKT 1104617020 0819/0008219        ,0.00,4700000,12413460257.29,19081200082190000139,
1533,12/08/2019,11:11:32,12/08/2019,11:11:32,0247 UKT 1307618002 0819/0009593        ,0.00,6250000,12419710257.29,19081200095930000034,
1534,12/08/2019,11:12:41,12/08/2019,11:12:41,0247 UKT 1308618061 0819/0008219        ,0.00,6250000,12425960257.29,19081200082190000141,
1535,12/08/2019,11:12:42,12/08/2019,11:12:42,0247 UKT 1939219016030 0819/0012234     ,0.00,4000000,12429960257.29,19081200122340000077,
1536,12/08/2019,11:12:55,12/08/2019,11:12:55,0247 UKT 1801617111 0819/0016600        ,0.00,6200000,12436160257.29,19081200166000000018,
1537,12/08/2019,11:13:11,12/08/2019,11:13:11,0247 UKT 1801617028 0819/0011952        ,0.00,4000000,12440160257.29,19081200119520000091,
1538,12/08/2019,11:13:35,12/08/2019,11:13:35,0247 UKT 1308618044 0819/0008219        ,0.00,4650000,12444810257.29,19081200082190000143,
1539,12/08/2019,11:13:43,12/08/2019,11:13:43,0247 UKT 1939219008728 0819/0017972     ,0.00,500000,12445310257.29,19081200179720000033,
1540,12/08/2019,11:14:36,12/08/2019,11:14:36,0247 UKT 1211617008 0819/0007897        ,0.00,5600000,12450910257.29,19081200078970000016,
1541,12/08/2019,11:16:03,12/08/2019,11:16:03,0247 UKT 1209617026 0819/0017017        ,0.00,6700000,12457610257.29,19081200170170000008,
1542,12/08/2019,11:16:25,12/08/2019,11:16:25,0247 UKT 1107617200 0819/0007897        ,0.00,5100000,12462710257.29,19081200078970000018,
1543,12/08/2019,11:16:46,12/08/2019,11:16:46,0247 UKT 1107618130 0819/0008219        ,0.00,3900000,12466610257.29,19081200082190000145,
1544,12/08/2019,11:17:17,12/08/2019,11:17:17,0247 UKT 1939119000261 0819/0011932     ,0.00,8800000,12475410257.29,19081200119320000022,
1545,12/08/2019,11:18:08,12/08/2019,11:18:08,0247 UKT 1939119003122 0819/0016621     ,0.00,3950000,12479360257.29,19081200166210000023,
1546,12/08/2019,11:18:16,12/08/2019,11:18:16,0247 UKT 1201618042 0819/0008219        ,0.00,4000000,12483360257.29,19081200082190000147,
1547,12/08/2019,11:19:58,12/08/2019,11:19:58,0247 UKT 1201618058 0819/0008219        ,0.00,5400000,12488760257.29,19081200082190000149,
1548,12/08/2019,11:22:01,12/08/2019,11:22:01,0247 UKT 1939219002335 0819/0008298     ,0.00,4500000,12493260257.29,19081200082980000017,
1549,12/08/2019,11:23:22,12/08/2019,11:23:22,0247 UKT 1603617034 0819/0007222        ,0.00,6500000,12499760257.29,19081200072220000029,
1550,12/08/2019,11:24:20,12/08/2019,11:24:20,0247 UKT 1939219011057 0819/0011952     ,0.00,5100000,12504860257.29,19081200119520000097,
1551,12/08/2019,11:24:45,12/08/2019,11:24:45,0247 UKT 1801618042 0819/0011978        ,0.00,4000000,12508860257.29,19081200119780000146,
1552,12/08/2019,11:24:55,12/08/2019,11:24:55,0247 UKT 1939219006929 0819/0008220     ,0.00,3900000,12512760257.29,19081200082200000048,
1553,12/08/2019,11:24:59,12/08/2019,11:24:59,0247 UKT 1308617060 0819/0007887        ,0.00,4150000,12516910257.29,19081200078870000078,
1554,12/08/2019,11:24:59,12/08/2019,11:24:59,0247 UKT 1602617043 0819/0017977        ,0.00,5400000,12522310257.29,19081200179770000107,
1555,12/08/2019,11:25:21,12/08/2019,11:25:21,0247 UKT 1939219010408 0819/0010423     ,0.00,3000000,12525310257.29,19081200104230000024,
1556,12/08/2019,11:26:31,12/08/2019,11:26:31,0247 UKT 1939119003029 0819/0017977     ,0.00,3800000,12529110257.29,19081200179770000109,
1557,12/08/2019,11:27:05,12/08/2019,11:27:05,0247 SPU 1939119003029 0819/0017977     ,0.00,750000,12529860257.29,19081200179770000111,
1558,12/08/2019,11:27:12,12/08/2019,11:27:12,0247 UKT 1211617027 0819/0013048        ,0.00,5000000,12534860257.29,19081200130480000166,
1559,12/08/2019,11:27:25,12/08/2019,11:27:25,0247 UKT 1939119001803 0819/0011806     ,0.00,4150000,12539010257.29,19081200118060000050,
1560,12/08/2019,11:27:43,12/08/2019,11:27:43,0247 UKT 1107617139 0819/0009627        ,0.00,3900000,12542910257.29,19081200096270000049,
1561,12/08/2019,11:28:29,12/08/2019,11:28:29,0247 UKT 1939219007348 0819/0008264     ,0.00,3900000,12546810257.29,19081200082640000052,
1562,12/08/2019,11:28:42,12/08/2019,11:28:42,0247 UKT 1209618010 0819/0008220        ,0.00,4500000,12551310257.29,19081200082200000050,
1563,12/08/2019,11:29:04,12/08/2019,11:29:04,0247 UKT 1939219001907 0819/0016533     ,0.00,4000000,12555310257.29,19081200165330000068,
1564,12/08/2019,11:29:50,12/08/2019,11:29:50,0247 SPU 1939219002929 0819/0008219     ,0.00,850000,12556160257.29,19081200082190000153,
1565,12/08/2019,11:30:12,12/08/2019,11:30:12,0247 SPU 1939219001907 0819/0016533     ,0.00,2000000,12558160257.29,19081200165330000072,
1566,12/08/2019,11:30:44,12/08/2019,11:30:44,0247 UKT 1203618035 0819/0008220        ,0.00,500000,12558660257.29,19081200082200000052,
1567,12/08/2019,11:31:39,12/08/2019,11:31:39,0247 UKT 1209618019 0819/0012491        ,0.00,4500000,12563160257.29,19081200124910000034,
1568,12/08/2019,11:32:06,12/08/2019,11:32:06,0247 UKT 1209618008 0819/0018015        ,0.00,4500000,12567660257.29,19081200180150000055,
1569,12/08/2019,11:32:25,12/08/2019,11:32:25,0247 UKT 1304618075 0819/0008219        ,0.00,9000000,12576660257.29,19081200082190000155,
1570,12/08/2019,11:33:51,12/08/2019,11:33:51,0247 UKT 1939219000199 0819/0008219     ,0.00,1000000,12577660257.29,19081200082190000157,
1571,12/08/2019,11:35:09,12/08/2019,11:35:09,0247 UKT 1107617046 0819/0009627        ,0.00,4500000,12582160257.29,19081200096270000051,
1572,12/08/2019,11:35:21,12/08/2019,11:35:21,0247 SPU 1939219000431 0819/0008298     ,0.00,5000000,12587160257.29,19081200082980000020,
1573,12/08/2019,11:35:48,12/08/2019,11:35:48,0247 UKT 1302617003 0819/0016660        ,0.00,4300000,12591460257.29,19081200166600000048,
1574,12/08/2019,11:35:53,12/08/2019,11:35:53,0247 UKT 1305617008 0819/0009761        ,0.00,4000000,12595460257.29,19081200097610000192,
1575,12/08/2019,11:35:58,12/08/2019,11:35:58,0247 UKT 1208617049 0819/0009760        ,0.00,7100000,12602560257.29,19081200097600000101,
1576,12/08/2019,11:36:44,12/08/2019,11:36:44,0247 UKT 1939219000431 0819/0008298     ,0.00,4500000,12607060257.29,19081200082980000022,
1577,12/08/2019,11:38:11,12/08/2019,11:38:11,0247 UKT 1303617073 0819/0012491        ,0.00,6200000,12613260257.29,19081200124910000036,
1578,12/08/2019,11:38:24,12/08/2019,11:38:24,0247 UKT 1939219001055 0819/0007357     ,0.00,1000000,12614260257.29,19081200073570000050,
1579,12/08/2019,11:40:30,12/08/2019,11:40:30,0247 UKT 1801617165 0819/0008219        ,0.00,6200000,12620460257.29,19081200082190000159,
1580,12/08/2019,11:42:01,12/08/2019,11:42:01,0247 UKT 1939119001674 0819/0008219     ,0.00,1000000,12621460257.29,19081200082190000161,
1581,12/08/2019,11:43:05,12/08/2019,11:43:05,0247 UKT 1939219008522 0819/0008219     ,0.00,1000000,12622460257.29,19081200082190000163,
1582,12/08/2019,11:45:25,12/08/2019,11:45:25,0247 UKT 1801618136 0819/0008219        ,0.00,8200000,12630660257.29,19081200082190000165,
1583,12/08/2019,11:45:46,12/08/2019,11:45:46,0247 UKT 1939219013482 0819/0016706     ,0.00,3700000,12634360257.29,19081200167060000110,
1584,12/08/2019,11:46:08,12/08/2019,11:46:08,0247 UKT 1601617072 0819/0018015        ,0.00,4000000,12638360257.29,19081200180150000059,
1585,12/08/2019,11:46:18,12/08/2019,11:46:18,0247 UKT                                ,0.00,7600000,12645960257.29,19081299142020674231,
1586,12/08/2019,11:47:54,12/08/2019,11:47:54,0247 UKT 1939319000942 0819/0008219     ,0.00,4000000,12649960257.29,19081200082190000167,
1587,12/08/2019,11:49:03,12/08/2019,11:49:03,0247 UKT 1939319000147 0819/0013506     ,0.00,3200000,12653160257.29,19081200135060000133,
1588,12/08/2019,11:50:18,12/08/2019,11:50:18,0247 SPU 1939319000147 0819/0013506     ,0.00,750000,12653910257.29,19081200135060000136,
1589,12/08/2019,11:51:07,12/08/2019,11:51:07,0247 UKT 1939219013921 0819/0008298     ,0.00,500000,12654410257.29,19081200082980000027,
1590,12/08/2019,11:53:01,12/08/2019,11:53:01,0247 UKT 1601617070 0819/0008219        ,0.00,2700000,12657110257.29,19081200082190000169,
1591,12/08/2019,11:53:04,12/08/2019,11:53:04,0247 UKT 1301618026 0819/0008220        ,0.00,3800000,12660910257.29,19081200082200000057,
1592,12/08/2019,11:56:19,12/08/2019,11:56:19,0247 UKT 1204618053 0819/0013048        ,0.00,5900000,12666810257.29,19081200130480000191,
1593,12/08/2019,11:56:46,12/08/2019,11:56:46,0247 UKT 1602617080 0819/0016715        ,0.00,3400000,12670210257.29,19081200167150000052,
1594,12/08/2019,11:57:24,12/08/2019,11:57:24,0247 UKT 1308618069 0819/0008219        ,0.00,6250000,12676460257.29,19081200082190000171,
1595,12/08/2019,11:58:44,12/08/2019,11:58:44,0247 UKT 1306617024 0819/0016706        ,0.00,6200000,12682660257.29,19081200167060000124,
1596,12/08/2019,11:59:25,12/08/2019,11:59:25,0247 UKT 1308618062 0819/0008219        ,0.00,6250000,12688910257.29,19081200082190000173,
1597,12/08/2019,12:00:27,12/08/2019,12:00:27,0247 UKT 1101617031 0819/0008219        ,0.00,4700000,12693610257.29,19081200082190000175,
1598,12/08/2019,12:01:44,12/08/2019,12:01:44,0247 UKT 1207618037 0819/0008219        ,0.00,1000000,12694610257.29,19081200082190000177,
1599,12/08/2019,12:01:54,12/08/2019,12:01:54,0247 UKT 1939219014128 0819/0016584     ,0.00,6900000,12701510257.29,19081200165840000130,
1600,12/08/2019,12:02:50,12/08/2019,12:02:50,0247 UKT 1939319000130 0819/0008219     ,0.00,6200000,12707710257.29,19081200082190000179,
1601,12/08/2019,12:08:43,12/08/2019,12:08:43,0247 UKT 1107617190 0819/0013069        ,0.00,500000,12708210257.29,19081200130690000066,
1602,12/08/2019,12:09:48,12/08/2019,12:09:48,0247 UKT 1939319000202 0819/0013482     ,0.00,1000000,12709210257.29,19081200134820000045,
1603,12/08/2019,12:14:04,12/08/2019,12:14:04,0247 UKT 1939219014060 0819/0017999     ,0.00,1000000,12710210257.29,19081200179990000016,
1604,12/08/2019,12:20:28,12/08/2019,12:20:28,0247 UKT                                ,0.00,4000000,12714210257.29,19081299113810935488,
1605,12/08/2019,12:20:46,12/08/2019,12:20:46,0247 UKT 1106618069 0819/0017977        ,0.00,3900000,12718110257.29,19081200179770000121,
1606,12/08/2019,12:21:38,12/08/2019,12:21:38,0247 UKT 1801617229 0819/0013056        ,0.00,8200000,12726310257.29,19081200130560000022,
1607,12/08/2019,12:22:14,12/08/2019,12:22:14,0247 UKT 1939219000930 0819/0008937     ,0.00,4300000,12730610257.29,19081200089370000030,
1608,12/08/2019,12:22:16,12/08/2019,12:22:16,0247 UKT 1939219015608 0819/0013066     ,0.00,3000000,12733610257.29,19081200130660000053,
1609,12/08/2019,12:24:00,12/08/2019,12:24:00,0247 UKT 1939119000922 0819/0013049     ,0.00,4650000,12738260257.29,19081200130490000071,
1610,12/08/2019,12:24:11,12/08/2019,12:24:11,0247 SPU 1939219017323 0819/0013765     ,0.00,10000000,12748260257.29,19081200137650000194,
1611,12/08/2019,12:24:42,12/08/2019,12:24:42,0247 UKT 1939219017323 0819/0013765     ,0.00,5100000,12753360257.29,19081200137650000196,
1612,12/08/2019,12:27:05,12/08/2019,12:27:05,0247 UKT 1801617130 0819/0010971        ,0.00,4000000,12757360257.29,19081200109710000020,
1613,12/08/2019,12:30:16,12/08/2019,12:30:16,0247 UKT 1302617048 0819/0010947        ,0.00,3800000,12761160257.29,19081200109470000020,
1614,12/08/2019,12:32:45,12/08/2019,12:32:45,0247 UKT 1939219009351 0819/0010413     ,0.00,6900000,12768060257.29,19081200104130000027,
1615,12/08/2019,12:36:40,12/08/2019,12:36:40,0247 SPU 1939219007121 0819/0017001     ,0.00,25000000,12793060257.29,19081200170010000049,
1616,12/08/2019,12:37:13,12/08/2019,12:37:13,0247 UKT 1939219007121 0819/0017001     ,0.00,7400000,12800460257.29,19081200170010000051,
1617,12/08/2019,12:38:39,12/08/2019,12:38:39,0247 UKT 1206617011 0819/0008264        ,0.00,5200000,12805660257.29,19081200082640000061,
1618,12/08/2019,12:40:42,12/08/2019,12:40:42,0247 SPU 1939219014567 0819/0018004     ,0.00,1500000,12807160257.29,19081200180040000030,
1619,12/08/2019,12:41:31,12/08/2019,12:41:31,0247 UKT 1939219014567 0819/0018004     ,0.00,5100000,12812260257.29,19081200180040000032,
1620,12/08/2019,12:43:51,12/08/2019,12:43:51,0247 UKT 1939319000542 0819/0007222     ,0.00,4000000,12816260257.29,19081200072220000047,
1621,12/08/2019,12:45:21,12/08/2019,12:45:21,0247 UKT 1939219004049 0819/0010493     ,0.00,3000000,12819260257.29,19081200104930000027,
1622,12/08/2019,12:46:26,12/08/2019,12:46:26,0247 UKT 1939219016076 0819/0016491     ,0.00,1000000,12820260257.29,19081200164910000176,
1623,12/08/2019,12:48:55,12/08/2019,12:48:55,0247 UKT 1106617060 0819/0016715        ,0.00,5100000,12825360257.29,19081200167150000062,
1624,12/08/2019,12:57:20,12/08/2019,12:57:20,0247 UKT 1602617112 0819/0008594        ,0.00,2700000,12828060257.29,19081200085940000039,
1625,12/08/2019,12:59:56,12/08/2019,12:59:56,0247 UKT 1939219006562 0819/0016525     ,0.00,3700000,12831760257.29,19081200165250000058,
1626,12/08/2019,13:00:32,12/08/2019,13:00:32,0247 UKT 1939219013566 0819/0012489     ,0.00,4300000,12836060257.29,19081200124890000059,
1627,12/08/2019,13:01:07,12/08/2019,13:01:07,0247 SPU 1939219013566 0819/0012489     ,0.00,750000,12836810257.29,19081200124890000061,
1628,12/08/2019,13:02:37,12/08/2019,13:02:37,0247 UKT 1208617056 0819/0008219        ,0.00,5900000,12842710257.29,19081200082190000189,
1629,12/08/2019,13:02:39,12/08/2019,13:02:39,0247 UKT 1939219013082 0819/0007367     ,0.00,6700000,12849410257.29,19081200073670000050,
1630,12/08/2019,13:04:22,12/08/2019,13:04:22,0247 UKT                                ,0.00,1000000,12850410257.29,19081299102060254130,
1631,12/08/2019,13:04:22,12/08/2019,13:04:22,0247 SPU 1939319000887 0819/0008219     ,0.00,10000000,12860410257.29,19081200082190000192,
1632,12/08/2019,13:04:24,12/08/2019,13:04:24,0247 UKT 1939319000881 0819/0018000     ,0.00,8200000,12868610257.29,19081200180000000039,
1633,12/08/2019,13:05:07,12/08/2019,13:05:07,0247 SPU 1939319000881 0819/0018000     ,0.00,2000000,12870610257.29,19081200180000000041,
1634,12/08/2019,13:05:32,12/08/2019,13:05:32,0247 UKT 1306617030 0819/0013447        ,0.00,6200000,12876810257.29,19081200134470000081,
1635,12/08/2019,13:06:57,12/08/2019,13:06:57,0247 UKT 1939219004173 0819/0008951     ,0.00,4000000,12880810257.29,19081200089510000018,
1636,12/08/2019,13:07:45,12/08/2019,13:07:45,0247 UKT 1303618055 0819/0008219        ,0.00,6200000,12887010257.29,19081200082190000196,
1637,12/08/2019,13:09:19,12/08/2019,13:09:19,0247 UKT 1201618037 0819/0013437        ,0.00,6000000,12893010257.29,19081200134370000097,
1638,12/08/2019,13:12:13,12/08/2019,13:12:13,0247 UKT 1314617031 0819/0017982        ,0.00,7300000,12900310257.29,19081200179820000093,
1639,12/08/2019,13:12:20,12/08/2019,13:12:20,0247 UKT 1939219013617 0819/0012490     ,0.00,1000000,12901310257.29,19081200124900000095,
1640,12/08/2019,13:13:21,12/08/2019,13:13:21,0247 UKT 1939219008927 0819/0013446     ,0.00,3000000,12904310257.29,19081200134460000067,
1641,12/08/2019,13:16:35,12/08/2019,13:16:35,0247 UKT 1304618071 0819/0008572        ,0.00,7500000,12911810257.29,19081200085720000122,
1642,12/08/2019,13:18:04,12/08/2019,13:18:04,0247 UKT 1801618095 0819/0013057        ,0.00,8200000,12920010257.29,19081200130570000055,
1643,12/08/2019,13:19:29,12/08/2019,13:19:29,0247 UKT 1101618028 0819/0007168        ,0.00,3000000,12923010257.29,19081200071680000145,
1644,12/08/2019,13:20:32,12/08/2019,13:20:32,0247 UKT 1107617184 0819/0016534        ,0.00,3900000,12926910257.29,19081200165340000027,
1645,12/08/2019,13:21:51,12/08/2019,13:21:51,0247 UKT 1939219004107 0819/0018019     ,0.00,6500000,12933410257.29,19081200180190000051,
1646,12/08/2019,13:22:49,12/08/2019,13:22:49,0247 UKT 1603617122 0819/0017966        ,0.00,4300000,12937710257.29,19081200179660000050,
1647,12/08/2019,13:23:44,12/08/2019,13:23:44,0247 UKT 1939119003203 0819/0016723     ,0.00,3800000,12941510257.29,19081200167230000023,
1648,12/08/2019,13:25:55,12/08/2019,13:25:55,0247 UKT 1302617063 0819/0016715        ,0.00,3800000,12945310257.29,19081200167150000082,
1649,12/08/2019,13:26:16,12/08/2019,13:26:16,0247 SPU 1939219002066 0819/0016997     ,0.00,1000000,12946310257.29,19081200169970000065,
1650,12/08/2019,13:26:58,12/08/2019,13:26:58,0247 UKT 1939219002066 0819/0016997     ,0.00,5900000,12952210257.29,19081200169970000067,
1651,12/08/2019,13:28:26,12/08/2019,13:28:26,0247 UKT 1939219010351 0819/0008214     ,0.00,4300000,12956510257.29,19081200082140000054,
1652,12/08/2019,13:29:06,12/08/2019,13:29:06,0247 UKT 1939119000961 0819/0012942     ,0.00,1000000,12957510257.29,19081200129420000045,
1653,12/08/2019,13:29:49,12/08/2019,13:29:49,0247 UKT 1939319000560 0819/0008586     ,0.00,3000000,12960510257.29,19081200085860000065,
1654,12/08/2019,13:31:17,12/08/2019,13:31:17,0247 UKT 1939219007021 0819/0016488     ,0.00,1000000,12961510257.29,19081200164880000020,
1655,12/08/2019,13:31:31,12/08/2019,13:31:31,0247 SPU 1939319000560 0819/0008586     ,0.00,750000,12962260257.29,19081200085860000067,
1656,12/08/2019,13:32:28,12/08/2019,13:32:28,0247 UKT 1101618073 0819/0012490        ,0.00,5300000,12967560257.29,19081200124900000097,
1657,12/08/2019,13:32:49,12/08/2019,13:32:49,0247 UKT 1102618018 0819/0008219        ,0.00,3000000,12970560257.29,19081200082190000198,
1658,12/08/2019,13:33:10,12/08/2019,13:33:10,0247 UKT 1801617288 0819/0007248        ,0.00,7200000,12977760257.29,19081200072480000070,
1659,12/08/2019,13:33:44,12/08/2019,13:33:44,0247 UKT 1801617079 0819/0016688        ,0.00,6200000,12983960257.29,19081200166880000076,
1660,12/08/2019,13:33:52,12/08/2019,13:33:52,0247 UKT 1304617036 0819/0007348        ,0.00,4500000,12988460257.29,19081200073480000088,
1661,12/08/2019,13:34:56,12/08/2019,13:34:56,0247 UKT                                ,0.00,5300000,12993760257.29,19081299113810489878,
1662,12/08/2019,13:36:23,12/08/2019,13:36:23,0247 UKT 1301617041 0819/0017017        ,0.00,6000000,12999760257.29,19081200170170000036,
1663,12/08/2019,13:36:36,12/08/2019,13:36:36,0247 UKT 1208617054 0819/0008219        ,0.00,4500000,13004260257.29,19081200082190000200,
1664,12/08/2019,13:38:53,12/08/2019,13:38:53,0247 UKT 1939219009006 0819/0008219     ,0.00,1000000,13005260257.29,19081200082190000203,
1665,12/08/2019,13:39:11,12/08/2019,13:39:11,0247 SPU 1939219009006 0819/0008219     ,0.00,750000,13006010257.29,19081200082190000205,
1666,12/08/2019,13:40:36,12/08/2019,13:40:36,0247 UKT 1107618147 0819/0006789        ,0.00,3900000,13009910257.29,19081200067890000017,
1667,12/08/2019,13:40:51,12/08/2019,13:40:51,0247 UKT 1304618068 0819/0017988        ,0.00,6200000,13016110257.29,19081200179880000067,
1668,12/08/2019,13:41:09,12/08/2019,13:41:09,0247 UKT 1939219016751 0819/0011952     ,0.00,1000000,13017110257.29,19081200119520000122,
1669,12/08/2019,13:41:17,12/08/2019,13:41:17,0247 UKT 1939319000749 0819/0008214     ,0.00,500000,13017610257.29,19081200082140000066,
1670,12/08/2019,13:42:54,12/08/2019,13:42:54,0247 UKT 1107617037 0819/0007168        ,0.00,5100000,13022710257.29,19081200071680000157,
1671,12/08/2019,13:43:05,12/08/2019,13:43:05,0247 SPU 1939219016751 0819/0011952     ,0.00,750000,13023460257.29,19081200119520000124,
1672,12/08/2019,13:43:29,12/08/2019,13:43:29,0247 SPU 1939119000202 0819/0007348     ,0.00,1000000,13024460257.29,19081200073480000092,
1673,12/08/2019,13:43:44,12/08/2019,13:43:44,0247 UKT 1107617206 0819/0008219        ,0.00,5100000,13029560257.29,19081200082190000209,
1674,12/08/2019,13:43:50,12/08/2019,13:43:50,0247 UKT 1939119000202 0819/0007348     ,0.00,6250000,13035810257.29,19081200073480000094,
1675,12/08/2019,13:43:55,12/08/2019,13:43:55,0247 UKT 1939219008061 0819/0017977     ,0.00,1000000,13036810257.29,19081200179770000132,
1676,12/08/2019,13:44:12,12/08/2019,13:44:12,0247 UKT 1107617253 0819/0012233        ,0.00,5100000,13041910257.29,19081200122330000067,
1677,12/08/2019,13:44:17,12/08/2019,13:44:17,0247 UKT                                ,0.00,8200000,13050110257.29,19081299566010560699,
1678,12/08/2019,13:46:00,12/08/2019,13:46:00,0247 UKT 1107617210 0819/0016659        ,0.00,3000000,13053110257.29,19081200166590000081,
1679,12/08/2019,13:46:40,12/08/2019,13:46:40,0247 UKT 1213617032 0819/0008220        ,0.00,3700000,13056810257.29,19081200082200000070,
1680,12/08/2019,13:48:33,12/08/2019,13:48:33,0247 UKT 1207618059 0819/0008296        ,0.00,1000000,13057810257.29,19081200082960000039,
1681,12/08/2019,13:49:21,12/08/2019,13:49:21,0247 UKT 1939219000842 0819/0018019     ,0.00,1000000,13058810257.29,19081200180190000059,
1682,12/08/2019,13:49:33,12/08/2019,13:49:33,0247 UKT 1939219012308 0819/0008586     ,0.00,5100000,13063910257.29,19081200085860000074,
1683,12/08/2019,13:50:15,12/08/2019,13:50:15,0247 UKT 1304617044 0819/0008219        ,0.00,6200000,13070110257.29,19081200082190000211,
1684,12/08/2019,13:53:25,12/08/2019,13:53:25,0247 SPU 1939219009075 0819/0008260     ,0.00,750000,13070860257.29,19081200082600000037,
1685,12/08/2019,13:53:50,12/08/2019,13:53:50,0247 UKT 1939219009075 0819/0008260     ,0.00,4000000,13074860257.29,19081200082600000039,
1686,12/08/2019,13:54:40,12/08/2019,13:54:40,0247 UKT 1939219006990 0819/0008253     ,0.00,5300000,13080160257.29,19081200082530000051,
1687,12/08/2019,13:54:53,12/08/2019,13:54:53,0247 UKT 1939219001673 0819/0008296     ,0.00,6200000,13086360257.29,19081200082960000046,
1688,12/08/2019,13:55:07,12/08/2019,13:55:07,0247 SPU 1939219006990 0819/0008253     ,0.00,750000,13087110257.29,19081200082530000053,
1689,12/08/2019,13:55:40,12/08/2019,13:55:40,0247 UKT 1205618041 0819/0017997        ,0.00,500000,13087610257.29,19081200179970000125,
1690,12/08/2019,13:56:03,12/08/2019,13:56:03,0247 UKT 1601617169 0819/0017363        ,0.00,4700000,13092310257.29,19081200173630000050,
1691,12/08/2019,13:56:51,12/08/2019,13:56:51,0247 UKT 1208617033 0819/0016717        ,0.00,7400000,13099710257.29,19081200167170000048,
1692,12/08/2019,13:57:09,12/08/2019,13:57:09,0247 UKT 1301617023 0819/0013498        ,0.00,6000000,13105710257.29,19081200134980000067,
1693,12/08/2019,13:59:49,12/08/2019,13:59:49,0247 UKT 1939219011844 0819/0006459     ,0.00,3000000,13108710257.29,19081200064590000138,
1694,12/08/2019,14:00:26,12/08/2019,14:00:26,0247 UKT 1314617006 0819/0012233        ,0.00,8300000,13117010257.29,19081200122330000076,
1695,12/08/2019,14:00:54,12/08/2019,14:00:54,0247 UKT 1939119002789 0819/0012489     ,0.00,4000000,13121010257.29,19081200124890000066,
1696,12/08/2019,14:01:51,12/08/2019,14:01:51,0247 UKT 1208618045 0819/0017978        ,0.00,6700000,13127710257.29,19081200179780000123,
1697,12/08/2019,14:02:28,12/08/2019,14:02:28,0247 UKT 1602617018 0819/0017970        ,0.00,3400000,13131110257.29,19081200179700000071,
1698,12/08/2019,14:02:59,12/08/2019,14:02:59,0247 UKT                                ,0.00,6200000,13137310257.29,19081299319010700867,
1699,12/08/2019,14:03:08,12/08/2019,14:03:08,0247 UKT 1939219006055 0819/0013066     ,0.00,1000000,13138310257.29,19081200130660000068,
1700,12/08/2019,14:03:40,12/08/2019,14:03:40,0247 SPU 1939219006055 0819/0013066     ,0.00,750000,13139060257.29,19081200130660000070,
1701,12/08/2019,14:08:46,12/08/2019,14:08:46,0247 UKT 1602617031 0819/0008577        ,0.00,4000000,13143060257.29,19081200085770000079,
1702,12/08/2019,14:08:51,12/08/2019,14:08:51,0247 UKT 1939219010674 0819/0016441     ,0.00,1000000,13144060257.29,19081200164410000099,
1703,12/08/2019,14:10:30,12/08/2019,14:10:30,0247 UKT 1303617016 0819/0016525        ,0.00,3950000,13148010257.29,19081200165250000100,
1704,12/08/2019,14:10:53,12/08/2019,14:10:53,0247 UKT 1204618026 0819/0009748        ,0.00,3900000,13151910257.29,19081200097480000045,
1705,12/08/2019,14:13:09,12/08/2019,14:13:09,0247 UKT 1939219011692 0819/0017770     ,0.00,1000000,13152910257.29,19081200177700000260,
1706,12/08/2019,14:13:38,12/08/2019,14:13:38,0247 UKT 1301617035 0819/0018001        ,0.00,500000,13153410257.29,19081200180010000077,
1707,12/08/2019,14:14:02,12/08/2019,14:14:02,0247 UKT 1103617021 0819/0018019        ,0.00,5300000,13158710257.29,19081200180190000063,
1708,12/08/2019,14:14:18,12/08/2019,14:14:18,0247 UKT 1601617186 0819/0008594        ,0.00,3400000,13162110257.29,19081200085940000044,
1709,12/08/2019,14:16:13,12/08/2019,14:16:13,0247 UKT 1601617187 0819/0008594        ,0.00,500000,13162610257.29,19081200085940000047,
1710,12/08/2019,14:17:25,12/08/2019,14:17:25,0247 UKT 1302618067 0819/0008179        ,0.00,6000000,13168610257.29,19081200081790000039,
1711,12/08/2019,14:18:24,12/08/2019,14:18:24,0247 UKT 1939219016911 0819/0017989     ,0.00,1000000,13169610257.29,19081200179890000061,
1712,12/08/2019,14:18:37,12/08/2019,14:18:37,0247 UKT 1939219004446 0819/0011958     ,0.00,4500000,13174110257.29,19081200119580000198,
1713,12/08/2019,14:22:53,12/08/2019,14:22:53,0247 UKT 1203618034 0819/0018015        ,0.00,3700000,13177810257.29,19081200180150000064,
1714,12/08/2019,14:23:41,12/08/2019,14:23:41,0247 UKT 1208617006 0819/0008219        ,0.00,6700000,13184510257.29,19081200082190000214,
1715,12/08/2019,14:25:20,12/08/2019,14:25:20,0247 UKT 1207618031 0819/0008219        ,0.00,4500000,13189010257.29,19081200082190000216,
1716,12/08/2019,14:25:39,12/08/2019,14:25:39,0247 UKT 1939119002047 0819/0013466     ,0.00,6250000,13195260257.29,19081200134660000078,
1717,12/08/2019,14:25:58,12/08/2019,14:25:58,0247 SPU 1939119002047 0819/0013466     ,0.00,2000000,13197260257.29,19081200134660000080,
1718,12/08/2019,14:26:15,12/08/2019,14:26:15,0247 UKT 1201618027 0819/0008219        ,0.00,4000000,13201260257.29,19081200082190000218,
1719,12/08/2019,14:27:41,12/08/2019,14:27:41,0247 UKT 1939219009812 0819/0008588     ,0.00,10300000,13211560257.29,19081200085880000058,
1720,12/08/2019,14:27:47,12/08/2019,14:27:47,0247 UKT 1303618060 0819/0013057        ,0.00,6200000,13217760257.29,19081200130570000082,
1721,12/08/2019,14:28:03,12/08/2019,14:28:03,0247 UKT 1939219016195 0819/0012249     ,0.00,4700000,13222460257.29,19081200122490000092,
1722,12/08/2019,14:29:25,12/08/2019,14:29:25,0247 SPU 1939219016195 0819/0012249     ,0.00,5000000,13227460257.29,19081200122490000094,
1723,12/08/2019,14:30:00,12/08/2019,14:30:00,0247 UKT 1203618008 0819/0017995        ,0.00,5600000,13233060257.29,19081200179950000056,
1724,12/08/2019,14:30:24,12/08/2019,14:30:24,0247 UKT 1304618013 0819/0016466        ,0.00,3950000,13237010257.29,19081200164660000144,
1725,12/08/2019,14:34:34,12/08/2019,14:34:34,0247 UKT 1207617039 0819/0008219        ,0.00,4500000,13241510257.29,19081200082190000225,
1726,12/08/2019,14:35:14,12/08/2019,14:35:14,0247 UKT 1801617062 0819/0016716        ,0.00,4000000,13245510257.29,19081200167160000056,
1727,12/08/2019,14:36:26,12/08/2019,14:36:26,0247 UKT 1922190181042 0819/0008219     ,0.00,3600000,13249110257.29,19081200082190000227,
1728,12/08/2019,14:36:34,12/08/2019,14:36:34,0247 UKT 1301617072 0819/0008220        ,0.00,1000000,13250110257.29,19081200082200000084,
1729,12/08/2019,14:38:08,12/08/2019,14:38:08,0247 UKT 1209617038 0819/0016723        ,0.00,7400000,13257510257.29,19081200167230000031,
1730,12/08/2019,14:38:15,12/08/2019,14:38:15,0247 UKT 1207617021 0819/0009551        ,0.00,4500000,13262010257.29,19081200095510000168,
1731,12/08/2019,14:38:26,12/08/2019,14:38:26,0247 UKT 1801617070 0819/0017989        ,0.00,4000000,13266010257.29,19081200179890000067,
1732,12/08/2019,14:40:12,12/08/2019,14:40:12,0247 UKT 1107618144 0819/0008220        ,0.00,5100000,13271110257.29,19081200082200000086,
1733,12/08/2019,14:41:26,12/08/2019,14:41:26,0247 UKT 1302617037 0819/0016990        ,0.00,6000000,13277110257.29,19081200169900000150,
1734,12/08/2019,14:41:45,12/08/2019,14:41:45,0247 UKT 1306618023 0819/0013083        ,0.00,4000000,13281110257.29,19081200130830000181,
1735,12/08/2019,14:43:17,12/08/2019,14:43:17,0247 UKT 1939319000199 0819/0017996     ,0.00,6500000,13287610257.29,19081200179960000099,
1736,12/08/2019,14:44:36,12/08/2019,14:44:36,0247 SPU 1939219003915 0819/0006168     ,0.00,750000,13288360257.29,19081200061680000093,
1737,12/08/2019,14:46:19,12/08/2019,14:46:19,0247 UKT 1939219003915 0819/0006168     ,0.00,3000000,13291360257.29,19081200061680000095,
1738,12/08/2019,14:46:49,12/08/2019,14:46:49,0247 UKT 1939119001213 0819/0011838     ,0.00,4150000,13295510257.29,19081200118380000044,
1739,12/08/2019,14:47:15,12/08/2019,14:47:15,0247 UKT 1603617073 0819/0012490        ,0.00,500000,13296010257.29,19081200124900000112,
1740,12/08/2019,14:47:25,12/08/2019,14:47:25,0247 SPU 1939119001213 0819/0011838     ,0.00,1000000,13297010257.29,19081200118380000046,
1741,12/08/2019,14:47:38,12/08/2019,14:47:38,0247 UKT 1939219000987 0819/0007357     ,0.00,3000000,13300010257.29,19081200073570000079,
1742,12/08/2019,14:47:45,12/08/2019,14:47:45,0247 UKT 1208617013 0819/0012938        ,0.00,6700000,13306710257.29,19081200129380000032,
1743,12/08/2019,14:48:23,12/08/2019,14:48:23,0247 UKT 1939119002923 0819/0008588     ,0.00,1000000,13307710257.29,19081200085880000076,
1744,12/08/2019,14:48:48,12/08/2019,14:48:48,0247 UKT 1939219013864 0819/0007900     ,0.00,6200000,13313910257.29,19081200079000000042,
1745,12/08/2019,14:48:53,12/08/2019,14:48:53,0247 UKT 1308617055 0819/0017989        ,0.00,6250000,13320160257.29,19081200179890000070,
1746,12/08/2019,14:48:59,12/08/2019,14:48:59,0247 SPU 1939119002923 0819/0008588     ,0.00,5000000,13325160257.29,19081200085880000078,
1747,12/08/2019,14:49:18,12/08/2019,14:49:18,0247 UKT 1801617230 0819/0017966        ,0.00,8200000,13333360257.29,19081200179660000066,
1748,12/08/2019,14:51:00,12/08/2019,14:51:00,0247 SPU 1939219013864 0819/0007900     ,0.00,2500000,13335860257.29,19081200079000000044,
1749,12/08/2019,14:52:48,12/08/2019,14:52:48,0247 UKT 1939219003668 0819/0017989     ,0.00,2700000,13338560257.29,19081200179890000072,
1750,12/08/2019,14:53:56,12/08/2019,14:53:56,0247 SPU 1939219003668 0819/0017989     ,0.00,1000000,13339560257.29,19081200179890000074,
1751,12/08/2019,14:54:43,12/08/2019,14:54:43,0247 UKT 1107617219 0819/0008574        ,0.00,5100000,13344660257.29,19081200085740000160,
1752,12/08/2019,14:54:56,12/08/2019,14:54:56,0247 UKT 1939319000553 0819/0010977     ,0.00,3000000,13347660257.29,19081200109770000011,
1753,12/08/2019,14:58:34,12/08/2019,14:58:34,0247 SPU 1939219012124 0819/0016489     ,0.00,750000,13348410257.29,19081200164890000041,
1754,12/08/2019,14:59:01,12/08/2019,14:59:01,0247 UKT 1939219012124 0819/0016489     ,0.00,3900000,13352310257.29,19081200164890000043,
1755,12/08/2019,15:03:29,12/08/2019,15:03:29,0247 UKT 1939219000501 0819/0008219     ,0.00,6500000,13358810257.29,19081200082190000231,
1756,12/08/2019,15:04:11,12/08/2019,15:04:11,0247 SPU 1939219000501 0819/0008219     ,0.00,750000,13359560257.29,19081200082190000233,
1757,12/08/2019,15:05:21,12/08/2019,15:05:21,0247 SPU 1939219002235 0819/0016442     ,0.00,750000,13360310257.29,19081200164420000044,
1758,12/08/2019,15:06:32,12/08/2019,15:06:32,0247 UKT 1939219002235 0819/0016442     ,0.00,6700000,13367010257.29,19081200164420000046,
1759,12/08/2019,15:09:18,12/08/2019,15:09:18,0247 UKT 1101617107 0819/0016441        ,0.00,500000,13367510257.29,19081200164410000111,
1760,12/08/2019,15:16:22,12/08/2019,15:16:22,0247 UKT 1302618038 0819/0012479        ,0.00,4300000,13371810257.29,19081200124790000076,
1761,12/08/2019,15:18:36,12/08/2019,15:18:36,0247 UKT 1801618041 0819/0008588        ,0.00,6200000,13378010257.29,19081200085880000091,
1762,12/08/2019,15:19:23,12/08/2019,15:19:23,0247 UKT 1603617030 0819/0012882        ,0.00,3200000,13381210257.29,19081200128820000149,
1763,12/08/2019,15:46:02,12/08/2019,15:46:02,0247 UKT                                ,0.00,6000000,13387210257.29,19081299547010502198,
1764,13/08/2019,08:04:16,13/08/2019,08:04:16,0247 UKT 1801617312 0819/0011829        ,0.00,8200000,13395410257.29,19081300118290000004,
1765,13/08/2019,08:06:04,13/08/2019,08:06:04,0247 UKT 1939219010914 0819/0016491     ,0.00,3900000,13399310257.29,19081300164910000002,
1766,13/08/2019,08:10:01,13/08/2019,08:10:01,0247 UKT 1939219007242 0819/0010961     ,0.00,4700000,13404010257.29,19081300109610000002,
1767,13/08/2019,08:19:14,13/08/2019,08:19:14,0247 UKT 1939219008265 0819/0007901     ,0.00,4300000,13408310257.29,19081300079010000005,
1768,13/08/2019,08:20:46,13/08/2019,08:20:46,0247 UKT 1210618057 0819/0011952        ,0.00,4600000,13412910257.29,19081300119520000010,
1769,13/08/2019,08:21:36,13/08/2019,08:21:36,0247 SPU 1939219015619 0819/0012937     ,0.00,750000,13413660257.29,19081300129370000003,
1770,13/08/2019,08:22:21,13/08/2019,08:22:21,0247 UKT 1939219015619 0819/0012937     ,0.00,4000000,13417660257.29,19081300129370000005,
1771,13/08/2019,08:26:26,13/08/2019,08:26:26,0247 UKT 1205618016 0819/0013063        ,0.00,3900000,13421560257.29,19081300130630000010,
1772,13/08/2019,08:28:09,13/08/2019,08:28:09,0247 UKT 1307617002 0819/0008219        ,0.00,4650000,13426210257.29,19081300082190000003,
1773,13/08/2019,08:33:06,13/08/2019,08:33:06,0247 UKT 1302617055 0819/0008219        ,0.00,3800000,13430010257.29,19081300082190000005,
1774,13/08/2019,08:34:09,13/08/2019,08:34:09,0247 UKT                                ,0.00,4150000,13434160257.29,19081399379070617381,
1775,13/08/2019,08:38:18,13/08/2019,08:38:18,0247 UKT 1209618037 0819/0016716        ,0.00,7100000,13441260257.29,19081300167160000002,
1776,13/08/2019,08:40:13,13/08/2019,08:40:13,0247 UKT                                ,0.00,5100000,13446360257.29,19081399276010687371,
1777,13/08/2019,08:41:24,13/08/2019,08:41:24,0247 SPU 1939219009984 0819/0008219     ,0.00,750000,13447110257.29,19081300082190000009,
1778,13/08/2019,08:42:07,13/08/2019,08:42:07,0247 UKT 1939219016116 0819/0012936     ,0.00,3700000,13450810257.29,19081300129360000004,
1779,13/08/2019,08:46:53,13/08/2019,08:46:53,0247 UKT 1801618164 0819/0010970        ,0.00,4000000,13454810257.29,19081300109700000027,
1780,13/08/2019,08:47:18,13/08/2019,08:47:18,0247 UKT 1106617019 0819/0016527        ,0.00,5100000,13459910257.29,19081300165270000010,
1781,13/08/2019,08:48:35,13/08/2019,08:48:35,0247 SPU 1939219000221 0819/0008953     ,0.00,10000000,13469910257.29,19081300089530000011,
1782,13/08/2019,08:48:57,13/08/2019,08:48:57,0247 UKT 1939219000221 0819/0008953     ,0.00,4700000,13474610257.29,19081300089530000013,
1783,13/08/2019,08:52:44,13/08/2019,08:52:44,0247 UKT 1304617026 0819/0016660        ,0.00,7500000,13482110257.29,19081300166600000008,
1784,13/08/2019,08:55:08,13/08/2019,08:55:08,0247 UKT 1939219015544 0819/0016489     ,0.00,500000,13482610257.29,19081300164890000003,
1785,13/08/2019,08:56:00,13/08/2019,08:56:00,0247 SPU 1939219015544 0819/0016489     ,0.00,750000,13483360257.29,19081300164890000005,
1786,13/08/2019,08:56:17,13/08/2019,08:56:17,0247 UKT 1939219009615 0819/0008219     ,0.00,5300000,13488660257.29,19081300082190000013,
1787,13/08/2019,08:57:59,13/08/2019,08:57:59,0247 UKT 1939319000038 0819/0008219     ,0.00,1000000,13489660257.29,19081300082190000015,
1788,13/08/2019,08:58:23,13/08/2019,08:58:23,0247 SPU 1939319000038 0819/0008219     ,0.00,750000,13490410257.29,19081300082190000017,
1789,13/08/2019,09:00:27,13/08/2019,09:00:27,0247 UKT 1304617037 0819/0008219        ,0.00,6200000,13496610257.29,19081300082190000019,
1790,13/08/2019,09:02:16,13/08/2019,09:02:16,0247 SPU 1939119004167 0819/0009763     ,0.00,5000000,13501610257.29,19081300097630000004,
1791,13/08/2019,09:02:40,13/08/2019,09:02:40,0247 UKT 1939219000674 0819/0008219     ,0.00,5100000,13506710257.29,19081300082190000021,
1792,13/08/2019,09:03:01,13/08/2019,09:03:01,0247 SPU 1939219000674 0819/0008219     ,0.00,750000,13507460257.29,19081300082190000023,
1793,13/08/2019,09:04:56,13/08/2019,09:04:56,0247 UKT 1939119000232 0819/0008219     ,0.00,3950000,13511410257.29,19081300082190000025,
1794,13/08/2019,09:06:05,13/08/2019,09:06:05,0247 UKT 1206617010 0819/0007901        ,0.00,7400000,13518810257.29,19081300079010000025,
1795,13/08/2019,09:06:37,13/08/2019,09:06:37,0247 UKT 1601617042 0819/0008225        ,0.00,4700000,13523510257.29,19081300082250000004,
1796,13/08/2019,09:07:17,13/08/2019,09:07:17,0247 UKT 1601618009 0819/0012248        ,0.00,1000000,13524510257.29,19081300122480000020,
1797,13/08/2019,09:08:26,13/08/2019,09:08:26,0247 UKT                                ,0.00,5600000,13530110257.29,19081399164010898952,
1798,13/08/2019,09:08:35,13/08/2019,09:08:35,0247 UKT 1801617069 0819/0009627        ,0.00,6200000,13536310257.29,19081300096270000002,
1799,13/08/2019,09:10:13,13/08/2019,09:10:13,0247 UKT 1603617116 0819/0016690        ,0.00,3200000,13539510257.29,19081300166900000033,
1800,13/08/2019,09:10:45,13/08/2019,09:10:45,0247 UKT 1305617019 0819/0018024        ,0.00,9000000,13548510257.29,19081300180240000007,
1801,13/08/2019,09:10:52,13/08/2019,09:10:52,0247 UKT 1939219017121 0819/0017008     ,0.00,5300000,13553810257.29,19081300170080000026,
1802,13/08/2019,09:11:26,13/08/2019,09:11:26,0247 SPU 1939219004107 0819/0008219     ,0.00,1000000,13554810257.29,19081300082190000027,
1803,13/08/2019,09:13:36,13/08/2019,09:13:36,0247 UKT 1314617027 0819/0013799        ,0.00,7300000,13562110257.29,19081300137990000024,
1804,13/08/2019,09:15:57,13/08/2019,09:15:57,0247 UKT 1303618078 0819/0008594        ,0.00,4500000,13566610257.29,19081300085940000002,
1805,13/08/2019,09:18:30,13/08/2019,09:18:30,0247 UKT 1104617030 0819/0017744        ,0.00,3000000,13569610257.29,19081300177440000026,
1806,13/08/2019,09:18:33,13/08/2019,09:18:33,0247 UKT 1939219005687 0819/0018004     ,0.00,6202000,13575812257.29,19081300180040000004,
1807,13/08/2019,09:19:04,13/08/2019,09:19:04,0247 UKT 1939219011095 0819/0005992     ,0.00,3000000,13578812257.29,19081300059920000005,
1808,13/08/2019,09:19:07,13/08/2019,09:19:07,0247 UKT 1939219009396 0819/0008219     ,0.00,3000000,13581812257.29,19081300082190000029,
1809,13/08/2019,09:19:23,13/08/2019,09:19:23,0247 SPU 1939219009396 0819/0008219     ,0.00,750000,13582562257.29,19081300082190000031,
1810,13/08/2019,09:26:14,13/08/2019,09:26:14,0247 UKT 1939219003554 0819/0016535     ,0.00,6700000,13589262257.29,19081300165350000090,
1811,13/08/2019,09:27:46,13/08/2019,09:27:46,0247 UKT 1303617019 0819/0013439        ,0.00,3950000,13593212257.29,19081300134390000014,
1812,13/08/2019,09:28:00,13/08/2019,09:28:00,0247 UKT 1203618016 0819/0008219        ,0.00,5600000,13598812257.29,19081300082190000033,
1813,13/08/2019,09:28:59,13/08/2019,09:28:59,0247 UKT 1939219014532 0819/0009746     ,0.00,9300000,13608112257.29,19081300097460000014,
1814,13/08/2019,09:30:21,13/08/2019,09:30:21,0247 UKT 1603617037 0819/0017973        ,0.00,500000,13608612257.29,19081300179730000021,
1815,13/08/2019,09:30:45,13/08/2019,09:30:45,0247 UKT 1939219012147 0819/0007248     ,0.00,3000000,13611612257.29,19081300072480000005,
1816,13/08/2019,09:31:51,13/08/2019,09:31:51,0247 SPU 1939219012147 0819/0007248     ,0.00,2000000,13613612257.29,19081300072480000007,
1817,13/08/2019,09:32:26,13/08/2019,09:32:26,0247 UKT 1105618032 0819/0012491        ,0.00,5800000,13619412257.29,19081300124910000013,
1818,13/08/2019,09:35:39,13/08/2019,09:35:39,0247 UKT 1939119000572 0819/0017017     ,0.00,4000000,13623412257.29,19081300170170000023,
1819,13/08/2019,09:36:10,13/08/2019,09:36:10,0247 UKT 1107617214 0819/0013055        ,0.00,3000000,13626412257.29,19081300130550000069,
1820,13/08/2019,09:37:46,13/08/2019,09:37:46,0247 UKT 1208618004 0819/0008219        ,0.00,5200000,13631612257.29,19081300082190000035,
1821,13/08/2019,09:38:22,13/08/2019,09:38:22,0247 UKT 1213617007 0819/0008572        ,0.00,5600000,13637212257.29,19081300085720000041,
1822,13/08/2019,09:40:20,13/08/2019,09:40:20,0247 UKT 1939219012836 0819/0012491     ,0.00,3000000,13640212257.29,19081300124910000019,
1823,13/08/2019,09:40:34,13/08/2019,09:40:34,0247 SPU 1939219011692 0819/0008219     ,0.00,750000,13640962257.29,19081300082190000037,
1824,13/08/2019,09:40:52,13/08/2019,09:40:52,0247 UKT 1939119002730 0819/0010403     ,0.00,7500000,13648462257.29,19081300104030000069,
1825,13/08/2019,09:41:15,13/08/2019,09:41:15,0247 UKT 1103617062 0819/0009659        ,0.00,4000000,13652462257.29,19081300096590000013,
1826,13/08/2019,09:41:33,13/08/2019,09:41:33,0247 SPU 1939119002730 0819/0010403     ,0.00,5000000,13657462257.29,19081300104030000071,
1827,13/08/2019,09:42:38,13/08/2019,09:42:38,0247 UKT 1102618012 0819/0009659        ,0.00,1000000,13658462257.29,19081300096590000015,
1828,13/08/2019,09:43:11,13/08/2019,09:43:11,0247 UKT 1303618056 0819/0017989        ,0.00,6200000,13664662257.29,19081300179890000019,
1829,13/08/2019,09:44:49,13/08/2019,09:44:49,0247 UKT 1308618011 0819/0008219        ,0.00,6250000,13670912257.29,19081300082190000039,
1830,13/08/2019,09:50:57,13/08/2019,09:50:57,0247 UKT 1939219007940 0819/0017768     ,0.00,5100000,13676012257.29,19081300177680000024,
1831,13/08/2019,09:51:03,13/08/2019,09:51:03,0247 UKT 1939219006955 0819/0013497     ,0.00,3200000,13679212257.29,19081300134970000015,
1832,13/08/2019,09:52:11,13/08/2019,09:52:11,0247 UKT 1106617061 0819/0008289        ,0.00,5100000,13684312257.29,19081300082890000020,
1833,13/08/2019,09:52:24,13/08/2019,09:52:24,0247 UKT 1801617118 0819/0016568        ,0.00,6200000,13690512257.29,19081300165680000053,
1834,13/08/2019,09:55:34,13/08/2019,09:55:34,0247 UKT 1939119002993 0819/0016619     ,0.00,6200000,13696712257.29,19081300166190000028,
1835,13/08/2019,09:55:48,13/08/2019,09:55:48,0247 SPU 1939219002505 0819/0013825     ,0.00,25000000,13721712257.29,19081300138250000034,
1836,13/08/2019,09:56:06,13/08/2019,09:56:06,0247 SPU 1939119002993 0819/0016619     ,0.00,1500000,13723212257.29,19081300166190000030,
1837,13/08/2019,09:56:15,13/08/2019,09:56:15,0247 UKT 1939219002505 0819/0013825     ,0.00,6000000,13729212257.29,19081300138250000036,
1838,13/08/2019,09:56:48,13/08/2019,09:56:48,0247 UKT 1101617104 0819/0018006        ,0.00,5300000,13734512257.29,19081300180060000023,
1839,13/08/2019,09:57:29,13/08/2019,09:57:29,0247 UKT 1306618004 0819/0009748        ,0.00,4000000,13738512257.29,19081300097480000010,
1840,13/08/2019,09:58:55,13/08/2019,09:58:55,0247 UKT 1939219010841 0819/0011829     ,0.00,4000000,13742512257.29,19081300118290000032,
1841,13/08/2019,09:59:23,13/08/2019,09:59:23,0247 UKT 1939319000814 0819/0010956     ,0.00,6200000,13748712257.29,19081300109560000066,
1842,13/08/2019,10:00:17,13/08/2019,10:00:17,0247 UKT 1105618039 0819/0008219        ,0.00,4500000,13753212257.29,19081300082190000041,
1843,13/08/2019,10:01:40,13/08/2019,10:01:40,0247 UKT 1301617006 0819/0008219        ,0.00,3800000,13757012257.29,19081300082190000043,
1844,13/08/2019,10:02:13,13/08/2019,10:02:13,0247 UKT 1301617055 0819/0013051        ,0.00,6000000,13763012257.29,19081300130510000049,
1845,13/08/2019,10:03:01,13/08/2019,10:03:01,0247 UKT 1107618050 0819/0016585        ,0.00,3900000,13766912257.29,19081300165850000028,
1846,13/08/2019,10:04:33,13/08/2019,10:04:33,0247 UKT 1939119004073 0819/0017969     ,0.00,6000000,13772912257.29,19081300179690000008,
1847,13/08/2019,10:05:13,13/08/2019,10:05:13,0247 UKT 1939219011130 0819/0010413     ,0.00,500000,13773412257.29,19081300104130000014,
1848,13/08/2019,10:05:21,13/08/2019,10:05:21,0247 UKT 1303617054 0819/0008219        ,0.00,3950000,13777362257.29,19081300082190000046,
1849,13/08/2019,10:06:02,13/08/2019,10:06:02,0247 UKT 1303618046 0819/0011831        ,0.00,6200000,13783562257.29,19081300118310000018,
1850,13/08/2019,10:06:09,13/08/2019,10:06:09,0247 UKT 1601618070 0819/0009760        ,0.00,2400000,13785962257.29,19081300097600000092,
1851,13/08/2019,10:06:25,13/08/2019,10:06:25,0247 SPU 1939119004073 0819/0017969     ,0.00,750000,13786712257.29,19081300179690000010,
1852,13/08/2019,10:08:31,13/08/2019,10:08:31,0247 CUT 1313618028 0819/0008219        ,0.00,500000,13787212257.29,19081300082190000048,
1853,13/08/2019,10:09:25,13/08/2019,10:09:25,0247 UKT 1939219005871 0819/0008267     ,0.00,3900000,13791112257.29,19081300082670000031,
1854,13/08/2019,10:12:38,13/08/2019,10:12:38,0247 UKT 1201617055 0819/0007348        ,0.00,4700000,13795812257.29,19081300073480000045,
1855,13/08/2019,10:13:46,13/08/2019,10:13:46,0247 UKT 1603617087 0819/0007887        ,0.00,6500000,13802312257.29,19081300078870000054,
1856,13/08/2019,10:18:06,13/08/2019,10:18:06,0247 UKT 1107617074 0819/0016528        ,0.00,3000000,13805312257.29,19081300165280000002,
1857,13/08/2019,10:18:39,13/08/2019,10:18:39,0247 UKT 1105618053 0819/0008219        ,0.00,3900000,13809212257.29,19081300082190000052,
1858,13/08/2019,10:20:42,13/08/2019,10:20:42,0247 UKT 1939219001309 0819/0008588     ,0.00,6700000,13815912257.29,19081300085880000032,
1859,13/08/2019,10:23:12,13/08/2019,10:23:12,0247 UKT 1303618077 0819/0013678        ,0.00,6200000,13822112257.29,19081300136780000030,
1860,13/08/2019,10:23:25,13/08/2019,10:23:25,0247 UKT 1101617054 0819/0009772        ,0.00,5300000,13827412257.29,19081300097720000019,
1861,13/08/2019,10:23:42,13/08/2019,10:23:42,0247 UKT 1104618061 0819/0007168        ,0.00,3000000,13830412257.29,19081300071680000110,
1862,13/08/2019,10:23:53,13/08/2019,10:23:53,0247 UKT 1314618008 0819/0008219        ,0.00,4000000,13834412257.29,19081300082190000054,
1863,13/08/2019,10:25:36,13/08/2019,10:25:36,0247 UKT 1939219008179 0819/0017987     ,0.00,5100000,13839512257.29,19081300179870000008,
1864,13/08/2019,10:26:13,13/08/2019,10:26:13,0247 SPU 1939219008179 0819/0016533     ,0.00,750000,13840262257.29,19081300165330000014,
1865,13/08/2019,10:28:08,13/08/2019,10:28:08,0247 UKT 1302617038 0819/0008219        ,0.00,6000000,13846262257.29,19081300082190000058,
1866,13/08/2019,10:29:17,13/08/2019,10:29:17,0247 UKT 1939219005590 0819/0013482     ,0.00,5900000,13852162257.29,19081300134820000010,
1867,13/08/2019,10:29:54,13/08/2019,10:29:54,0247 UKT 1303617060 0819/0012882        ,0.00,3950000,13856112257.29,19081300128820000030,
1868,13/08/2019,10:30:48,13/08/2019,10:30:48,0247 UKT 1939119001638 0819/0009602     ,0.00,6200000,13862312257.29,19081300096020000029,
1869,13/08/2019,10:31:51,13/08/2019,10:31:51,0247 SPU 1939119001638 0819/0009602     ,0.00,750000,13863062257.29,19081300096020000031,
1870,13/08/2019,10:31:52,13/08/2019,10:31:52,0247 SPU 1939219005590 0819/0013482     ,0.00,100000000,13963062257.29,19081300134820000014,
1871,13/08/2019,10:33:08,13/08/2019,10:33:08,0247 UKT 1939219002369 0819/0016491     ,0.00,8200000,13971262257.29,19081300164910000060,
1872,13/08/2019,10:33:34,13/08/2019,10:33:34,0247 UKT 1205617114 0819/0008219        ,0.00,3900000,13975162257.29,19081300082190000060,
1873,13/08/2019,10:33:49,13/08/2019,10:33:49,0247 SPU 1939219002369 0819/0016491     ,0.00,10000000,13985162257.29,19081300164910000062,
1874,13/08/2019,10:34:24,13/08/2019,10:34:24,0247 UKT 1305618011 0819/0011958        ,0.00,6200000,13991362257.29,19081300119580000114,
1875,13/08/2019,10:36:07,13/08/2019,10:36:07,0247 UKT 1939219010079 0819/0008219     ,0.00,3000000,13994362257.29,19081300082190000062,
1876,13/08/2019,10:36:24,13/08/2019,10:36:24,0247 SPU 1939219010079 0819/0008219     ,0.00,750000,13995112257.29,19081300082190000064,
1877,13/08/2019,10:38:08,13/08/2019,10:38:08,0247 UKT 1304618006 0819/0008219        ,0.00,3950000,13999062257.29,19081300082190000067,
1878,13/08/2019,10:39:02,13/08/2019,10:39:02,0247 SPU 1939119002062 0819/0008219     ,0.00,750000,13999812257.29,19081300082190000069,
1879,13/08/2019,10:40:08,13/08/2019,10:40:08,0247 UKT 1601617074 0819/0017969        ,0.00,4700000,14004512257.29,19081300179690000013,
1880,13/08/2019,10:42:26,13/08/2019,10:42:26,0247 UKT 1801617009 0819/0013465        ,0.00,4000000,14008512257.29,19081300134650000094,
1881,13/08/2019,10:42:48,13/08/2019,10:42:48,0247 UKT 1939119003602 0819/0008957     ,0.00,4000000,14012512257.29,19081300089570000036,
1882,13/08/2019,10:42:53,13/08/2019,10:42:53,0247 UKT 1302617009 0819/0007019        ,0.00,9000000,14021512257.29,19081300070190000026,
1883,13/08/2019,10:44:13,13/08/2019,10:44:13,0247 UKT 1939219012175 0819/0008214     ,0.00,5300000,14026812257.29,19081300082140000046,
1884,13/08/2019,10:44:18,13/08/2019,10:44:18,0247 UKT 1301617044 0819/0007019        ,0.00,6000000,14032812257.29,19081300070190000028,
1885,13/08/2019,10:47:30,13/08/2019,10:47:30,0247 UKT 1939219002307 0819/0012247     ,0.00,6400000,14039212257.29,19081300122470000034,
1886,13/08/2019,10:47:32,13/08/2019,10:47:32,0247 UKT 1210618051 0819/0011540        ,0.00,1000000,14040212257.29,19081300115400000011,
1887,13/08/2019,10:48:18,13/08/2019,10:48:18,0247 UKT 1602618004 0819/0018021        ,0.00,4700000,14044912257.29,19081300180210000050,
1888,13/08/2019,10:48:21,13/08/2019,10:48:21,0247 UKT 1939219006427 0819/0008219     ,0.00,4500000,14049412257.29,19081300082190000071,
1889,13/08/2019,10:48:31,13/08/2019,10:48:31,0247 UKT 1203617071 0819/0011958        ,0.00,3700000,14053112257.29,19081300119580000125,
1890,13/08/2019,10:50:44,13/08/2019,10:50:44,0247 UKT 1107618070 0819/0012490        ,0.00,5100000,14058212257.29,19081300124900000042,
1891,13/08/2019,10:51:03,13/08/2019,10:51:03,0247 UKT 1939119001740 0819/0008219     ,0.00,3800000,14062012257.29,19081300082190000073,
1892,13/08/2019,10:51:05,13/08/2019,10:51:05,0247 UKT 1209617013 0819/0016441        ,0.00,4500000,14066512257.29,19081300164410000062,
1893,13/08/2019,10:51:32,13/08/2019,10:51:32,0247 SPU 1939119001740 0819/0008219     ,0.00,1000000,14067512257.29,19081300082190000075,
1894,13/08/2019,10:53:19,13/08/2019,10:53:19,0247 UKT 1107618125 0819/0009748        ,0.00,3900000,14071412257.29,19081300097480000012,
1895,13/08/2019,10:54:01,13/08/2019,10:54:01,0247 UKT 1107617193 0819/0008219        ,0.00,5100000,14076512257.29,19081300082190000077,
1896,13/08/2019,10:54:27,13/08/2019,10:54:27,0247 UKT 1939219009549 0819/0013823     ,0.00,5900000,14082412257.29,19081300138230000070,
1897,13/08/2019,10:54:56,13/08/2019,10:54:56,0247 SPU 1939219009549 0819/0013823     ,0.00,2000000,14084412257.29,19081300138230000072,
1898,13/08/2019,10:55:17,13/08/2019,10:55:17,0247 UKT 1202618027 0819/0007248        ,0.00,5900000,14090312257.29,19081300072480000031,
1899,13/08/2019,10:55:27,13/08/2019,10:55:27,0247 UKT 1939319000110 0819/0011829     ,0.00,6400000,14096712257.29,19081300118290000047,
1900,13/08/2019,10:56:43,13/08/2019,10:56:43,0247 UKT 1939119001278 0819/0008219     ,0.00,1000000,14097712257.29,19081300082190000080,
1901,13/08/2019,10:57:48,13/08/2019,10:57:48,0247 UKT 1939219016554 0819/0016491     ,0.00,500000,14098212257.29,19081300164910000064,
1902,13/08/2019,10:58:11,13/08/2019,10:58:11,0247 SPU 1939219016554 0819/0016491     ,0.00,750000,14098962257.29,19081300164910000066,
1903,13/08/2019,10:58:57,13/08/2019,10:58:57,0247 UKT 1601617015 0819/0008594        ,0.00,4700000,14103662257.29,19081300085940000004,
1904,13/08/2019,11:00:00,13/08/2019,11:00:00,0247 UKT 1106617062 0819/0008219        ,0.00,5100000,14108762257.29,19081300082190000084,
1905,13/08/2019,11:01:05,13/08/2019,11:01:05,0247 UKT 1939219004770 0819/0008219     ,0.00,1000000,14109762257.29,19081300082190000086,
1906,13/08/2019,11:01:19,13/08/2019,11:01:19,0247 UKT 1107618033 0819/0017017        ,0.00,5100000,14114862257.29,19081300170170000038,
1907,13/08/2019,11:03:26,13/08/2019,11:03:26,0247 UKT 1939319000347 0819/0010932     ,0.00,4300000,14119162257.29,19081300109320000024,
1908,13/08/2019,11:03:48,13/08/2019,11:03:48,0247 UKT 1306618031 0819/0016491        ,0.00,4000000,14123162257.29,19081300164910000068,
1909,13/08/2019,11:05:32,13/08/2019,11:05:32,0247 UKT 1939219011201 0819/0008219     ,0.00,6500000,14129662257.29,19081300082190000088,
1910,13/08/2019,11:05:58,13/08/2019,11:05:58,0247 SPU 1939219011201 0819/0008219     ,0.00,8000000,14137662257.29,19081300082190000090,
1911,13/08/2019,11:06:17,13/08/2019,11:06:17,0247 UKT 1939219002816 0819/0018013     ,0.00,3000000,14140662257.29,19081300180130000081,
1912,13/08/2019,11:07:44,13/08/2019,11:07:44,0247 UKT 1939319000144 0819/0008219     ,0.00,500000,14141162257.29,19081300082190000092,
1913,13/08/2019,11:08:43,13/08/2019,11:08:43,0247 UKT 1939219014836 0819/0016708     ,0.00,3900000,14145062257.29,19081300167080000012,
1914,13/08/2019,11:08:51,13/08/2019,11:08:51,0247 SPU 1939219015142 0819/0008574     ,0.00,750000,14145812257.29,19081300085740000050,
1915,13/08/2019,11:08:52,13/08/2019,11:08:52,0247 UKT 1939219017079 0819/0009628     ,0.00,4500000,14150312257.29,19081300096280000009,
1916,13/08/2019,11:09:15,13/08/2019,11:09:15,0247 UKT 1939219015142 0819/0008574     ,0.00,5100000,14155412257.29,19081300085740000052,
1917,13/08/2019,11:09:27,13/08/2019,11:09:27,0247 UKT 1939219011355 0819/0008219     ,0.00,2700000,14158112257.29,19081300082190000094,
1918,13/08/2019,11:09:39,13/08/2019,11:09:39,0247 SPU 1939219017079 0819/0009628     ,0.00,750000,14158862257.29,19081300096280000011,
1919,13/08/2019,11:10:15,13/08/2019,11:10:15,0247 SPU 1939219015104 0819/0016717     ,0.00,3450000,14162312257.29,19081300167170000017,
1920,13/08/2019,11:10:37,13/08/2019,11:10:37,0247 UKT 1939219015104 0819/0016717     ,0.00,3900000,14166212257.29,19081300167170000019,
1921,13/08/2019,11:11:20,13/08/2019,11:11:20,0247 UKT 1939119001525 0819/0016659     ,0.00,6250000,14172462257.29,19081300166590000057,
1922,13/08/2019,11:12:34,13/08/2019,11:12:34,0247 UKT 1105618015 0819/0011540        ,0.00,5100000,14177562257.29,19081300115400000017,
1923,13/08/2019,11:15:35,13/08/2019,11:15:35,0247 UKT 1939119003418 0819/0016657     ,0.00,1000000,14178562257.29,19081300166570000055,
1924,13/08/2019,11:15:39,13/08/2019,11:15:39,0247 UKT 1939219003552 0819/0008547     ,0.00,4000000,14182562257.29,19081300085470000012,
1925,13/08/2019,11:15:57,13/08/2019,11:15:57,0247 UKT 1939219002558 0819/0008219     ,0.00,3200000,14185762257.29,19081300082190000098,
1926,13/08/2019,11:17:39,13/08/2019,11:17:39,0247 UKT 1939219000646 0819/0008219     ,0.00,4700000,14190462257.29,19081300082190000100,
1927,13/08/2019,11:17:54,13/08/2019,11:17:54,0247 UKT 1306617007 0819/0012490        ,0.00,6200000,14196662257.29,19081300124900000049,
1928,13/08/2019,11:18:32,13/08/2019,11:18:32,0247 UKT 1602617021 0819/0016441        ,0.00,4700000,14201362257.29,19081300164410000073,
1929,13/08/2019,11:19:17,13/08/2019,11:19:17,0247 SPU 1939219000646 0819/0008219     ,0.00,3000000,14204362257.29,19081300082190000102,
1930,13/08/2019,11:19:34,13/08/2019,11:19:34,0247 SPU 1939119001525 0819/0016659     ,0.00,2500000,14206862257.29,19081300166590000059,
1931,13/08/2019,11:21:11,13/08/2019,11:21:11,0247 UKT 1102617103 0819/0008220        ,0.00,500000,14207362257.29,19081300082200000024,
1932,13/08/2019,11:21:16,13/08/2019,11:21:16,0247 UKT 1939219002029 0819/0008219     ,0.00,5400000,14212762257.29,19081300082190000104,
1933,13/08/2019,11:21:34,13/08/2019,11:21:34,0247 SPU 1939219002029 0819/0008219     ,0.00,1000000,14213762257.29,19081300082190000106,
1934,13/08/2019,11:23:15,13/08/2019,11:23:15,0247 UKT 1939219000233 0819/0008219     ,0.00,3200000,14216962257.29,19081300082190000108,
1935,13/08/2019,11:25:30,13/08/2019,11:25:30,0247 UKT 1939219006838 0819/0008219     ,0.00,2700000,14219662257.29,19081300082190000110,
1936,13/08/2019,11:27:04,13/08/2019,11:27:04,0247 UKT 1939219015968 0819/0008219     ,0.00,6500000,14226162257.29,19081300082190000112,
1937,13/08/2019,11:28:52,13/08/2019,11:28:52,0247 UKT 1939219002500 0819/0018021     ,0.00,4500000,14230662257.29,19081300180210000059,
1938,13/08/2019,11:29:03,13/08/2019,11:29:03,0247 UKT 1801618036 0819/0008219        ,0.00,9300000,14239962257.29,19081300082190000114,
1939,13/08/2019,11:30:10,13/08/2019,11:30:10,0247 UKT 1204618041 0819/0008219        ,0.00,3900000,14243862257.29,19081300082190000116,
1940,13/08/2019,11:30:33,13/08/2019,11:30:33,0247 UKT 1306617032 0819/0013048        ,0.00,4000000,14247862257.29,19081300130480000102,
1941,13/08/2019,11:31:08,13/08/2019,11:31:08,0247 UKT 1939119002433 0819/0008219     ,0.00,1000000,14248862257.29,19081300082190000118,
1942,13/08/2019,11:32:26,13/08/2019,11:32:26,0247 UKT 1602617158 0819/0008594        ,0.00,2700000,14251562257.29,19081300085940000006,
1943,13/08/2019,11:33:03,13/08/2019,11:33:03,0247 UKT 1939219007799 0819/0008219     ,0.00,5900000,14257462257.29,19081300082190000120,
1944,13/08/2019,11:33:25,13/08/2019,11:33:25,0247 SPU 1939219007799 0819/0008219     ,0.00,750000,14258212257.29,19081300082190000122,
1945,13/08/2019,11:33:31,13/08/2019,11:33:31,0247 UKT 1939219006084 0819/0012480     ,0.00,5900000,14264112257.29,19081300124800000039,
1946,13/08/2019,11:34:47,13/08/2019,11:34:47,0247 UKT 1939219008798 0819/0008219     ,0.00,1000000,14265112257.29,19081300082190000124,
1947,13/08/2019,11:35:01,13/08/2019,11:35:01,0247 UKT 1206618028 0819/0013762        ,0.00,4500000,14269612257.29,19081300137620000049,
1948,13/08/2019,11:35:45,13/08/2019,11:35:45,0247 UKT                                ,0.00,8000000,14277612257.29,19081399113810065726,
1949,13/08/2019,11:36:01,13/08/2019,11:36:01,0247 UKT 1106618074 0819/0008219        ,0.00,5100000,14282712257.29,19081300082190000126,
1950,13/08/2019,11:36:36,13/08/2019,11:36:36,0247 UKT 1939219015339 0819/0017995     ,0.00,6472000,14289184257.29,19081300179950000016,
1951,13/08/2019,11:37:11,13/08/2019,11:37:11,0247 UKT 1939119002689 0819/0008219     ,0.00,6250000,14295434257.29,19081300082190000128,
1952,13/08/2019,11:37:26,13/08/2019,11:37:26,0247 SPU 1939119002689 0819/0008219     ,0.00,750000,14296184257.29,19081300082190000130,
1953,13/08/2019,11:38:10,13/08/2019,11:38:10,0247 UKT                                ,0.00,8800000,14304984257.29,19081399552010083687,
1954,13/08/2019,11:38:48,13/08/2019,11:38:48,0247 UKT 1939219007238 0819/0008219     ,0.00,4000000,14308984257.29,19081300082190000132,
1955,13/08/2019,11:39:03,13/08/2019,11:39:03,0247 SPU 1939219007238 0819/0008219     ,0.00,800000,14309784257.29,19081300082190000134,
1956,13/08/2019,11:40:04,13/08/2019,11:40:04,0247 UKT 1106617063 0819/0013051        ,0.00,5100000,14314884257.29,19081300130510000061,
1957,13/08/2019,11:40:31,13/08/2019,11:40:31,0247 UKT 1939219013550 0819/0008219     ,0.00,6202000,14321086257.29,19081300082190000137,
1958,13/08/2019,11:40:44,13/08/2019,11:40:44,0247 SPU 1939219013550 0819/0008219     ,0.00,750000,14321836257.29,19081300082190000139,
1959,13/08/2019,11:41:07,13/08/2019,11:41:07,0247 UKT 1939119004114 0819/0013498     ,0.00,6200000,14328036257.29,19081300134980000018,
1960,13/08/2019,11:42:33,13/08/2019,11:42:33,0247 SPU 1939119004114 0819/0013498     ,0.00,750000,14328786257.29,19081300134980000020,
1961,13/08/2019,11:42:45,13/08/2019,11:42:45,0247 UKT 1207617018 0819/0009659        ,0.00,6700000,14335486257.29,19081300096590000037,
1962,13/08/2019,11:43:11,13/08/2019,11:43:11,0247 UKT 1939119003334 0819/0012234     ,0.00,6000000,14341486257.29,19081300122340000045,
1963,13/08/2019,11:43:27,13/08/2019,11:43:27,0247 UKT 1939219002714 0819/0008219     ,0.00,3200000,14344686257.29,19081300082190000141,
1964,13/08/2019,11:43:36,13/08/2019,11:43:36,0247 SPU 1939119003334 0819/0012234     ,0.00,750000,14345436257.29,19081300122340000047,
1965,13/08/2019,11:44:29,13/08/2019,11:44:29,0247 UKT 1939219016064 0819/0008219     ,0.00,6700000,14352136257.29,19081300082190000143,
1966,13/08/2019,11:44:52,13/08/2019,11:44:52,0247 SPU 1939219016064 0819/0008219     ,0.00,750000,14352886257.29,19081300082190000145,
1967,13/08/2019,11:46:13,13/08/2019,11:46:13,0247 UKT 1939219005397 0819/0008574     ,0.00,4500000,14357386257.29,19081300085740000056,
1968,13/08/2019,11:46:19,13/08/2019,11:46:19,0247 UKT 1939219016846 0819/0008219     ,0.00,1000000,14358386257.29,19081300082190000147,
1969,13/08/2019,11:46:35,13/08/2019,11:46:35,0247 SPU 1939219016846 0819/0008219     ,0.00,750000,14359136257.29,19081300082190000149,
1970,13/08/2019,11:47:09,13/08/2019,11:47:09,0247 UKT 1939119001829 0819/0008207     ,0.00,4000000,14363136257.29,19081300082070000144,
1971,13/08/2019,11:47:31,13/08/2019,11:47:31,0247 UKT 1801618093 0819/0007751        ,0.00,6200000,14369336257.29,19081300077510000010,
1972,13/08/2019,11:48:45,13/08/2019,11:48:45,0247 UKT 1308617048 0819/0008219        ,0.00,6250000,14375586257.29,19081300082190000151,
1973,13/08/2019,11:49:39,13/08/2019,11:49:39,0247 SPU 1939119001829 0819/0008207     ,0.00,750000,14376336257.29,19081300082070000146,
1974,13/08/2019,11:50:32,13/08/2019,11:50:32,0247 UKT 1303618039 0819/0011806        ,0.00,3950000,14380286257.29,19081300118060000060,
1975,13/08/2019,11:50:47,13/08/2019,11:50:47,0247 SPU 1939319000631 0819/0008219     ,0.00,7000000,14387286257.29,19081300082190000154,
1976,13/08/2019,11:51:41,13/08/2019,11:51:41,0247 UKT 1205618047 0819/0017789        ,0.00,6400000,14393686257.29,19081300177890000046,
1977,13/08/2019,11:51:57,13/08/2019,11:51:57,0247 UKT 1304618023 0819/0008219        ,0.00,6200000,14399886257.29,19081300082190000156,
1978,13/08/2019,11:52:47,13/08/2019,11:52:47,0247 UKT 1201618060 0819/0008219        ,0.00,1000000,14400886257.29,19081300082190000158,
1979,13/08/2019,11:56:12,13/08/2019,11:56:12,0247 UKT 1939219002773 0819/0016207     ,0.00,8200000,14409086257.29,19081300162070000007,
1980,13/08/2019,11:56:14,13/08/2019,11:56:14,0247 UKT 1204618023 0819/0008219        ,0.00,3900000,14412986257.29,19081300082190000160,
1981,13/08/2019,12:04:10,13/08/2019,12:04:10,0247 UKT 1209618048 0819/0006664        ,0.00,4500000,14417486257.29,19081300066640000030,
1982,13/08/2019,12:04:46,13/08/2019,12:04:46,0247 UKT 1939219011756 0819/0016717     ,0.00,500000,14417986257.29,19081300167170000023,
1983,13/08/2019,12:04:57,13/08/2019,12:04:57,0247 UKT 1602617120 0819/0008594        ,0.00,4000000,14421986257.29,19081300085940000012,
1984,13/08/2019,12:12:13,13/08/2019,12:12:13,0247 UKT 1939219016161 0819/0006664     ,0.00,5300000,14427286257.29,19081300066640000032,
1985,13/08/2019,12:12:54,13/08/2019,12:12:54,0247 UKT 1939119003460 0819/0008586     ,0.00,4000000,14431286257.29,19081300085860000038,
1986,13/08/2019,12:14:08,13/08/2019,12:14:08,0247 UKT 1939219014861 0819/0007248     ,0.00,5500000,14436786257.29,19081300072480000041,
1987,13/08/2019,12:30:59,13/08/2019,12:30:59,0247 UKT 1209617035 0819/0007348        ,0.00,7100000,14443886257.29,19081300073480000066,
1988,13/08/2019,12:33:14,13/08/2019,12:33:14,0247 UKT 1939219012863 0819/0008214     ,0.00,3900000,14447786257.29,19081300082140000063,
1989,13/08/2019,12:33:48,13/08/2019,12:33:48,0247 SPU 1939219012863 0819/0008214     ,0.00,1000000,14448786257.29,19081300082140000065,
1990,13/08/2019,12:37:10,13/08/2019,12:37:10,0247 UKT 1939219008227 0819/0013076     ,0.00,3000000,14451786257.29,19081300130760000027,
1991,13/08/2019,12:52:24,13/08/2019,12:52:24,0247 UKT 1107617242 0819/0008957        ,0.00,3000000,14454786257.29,19081300089570000044,
1992,13/08/2019,12:55:36,13/08/2019,12:55:36,0247 UKT                                ,0.00,4000000,14458786257.29,19081399113810643263,
1993,13/08/2019,12:56:14,13/08/2019,12:56:14,0247 UKT 1939319000843 0819/0016657     ,0.00,4500000,14463286257.29,19081300166570000077,
1994,13/08/2019,12:56:34,13/08/2019,12:56:34,0247 UKT 1801618058 0819/0016619        ,0.00,4000000,14467286257.29,19081300166190000120,
1995,13/08/2019,12:59:35,13/08/2019,12:59:35,0247 UKT 1208618044 0819/0013487        ,0.00,4500000,14471786257.29,19081300134870000051,
1996,13/08/2019,13:00:50,13/08/2019,13:00:50,0247 UKT 1205617021 0819/0010413        ,0.00,5200000,14476986257.29,19081300104130000029,
1997,13/08/2019,13:01:08,13/08/2019,13:01:08,0247 UKT 1801618030 0819/0006710        ,0.00,4000000,14480986257.29,19081300067100000031,
1998,13/08/2019,13:01:26,13/08/2019,13:01:26,0247 UKT 1801617081 0819/0013452        ,0.00,4000000,14484986257.29,19081300134520000152,
1999,13/08/2019,13:03:56,13/08/2019,13:03:56,0247 UKT 1105617031 0819/0016484        ,0.00,3000000,14487986257.29,19081300164840000083,
2000,13/08/2019,13:05:16,13/08/2019,13:05:16,0247 UKT 1601618054 0819/0013447        ,0.00,4700000,14492686257.29,19081300134470000047,
2001,13/08/2019,13:06:41,13/08/2019,13:06:41,0247 UKT 1304617065 0819/0012479        ,0.00,7500000,14500186257.29,19081300124790000039,
2002,13/08/2019,13:13:25,13/08/2019,13:13:25,0247 UKT 1302618054 0819/0008181        ,0.00,6000000,14506186257.29,19081300081810000033,
2003,13/08/2019,13:13:45,13/08/2019,13:13:45,0247 UKT 1302618014 0819/0013057        ,0.00,4300000,14510486257.29,19081300130570000035,
2004,13/08/2019,13:20:00,13/08/2019,13:20:00,0247 UKT 1939119003509 0819/0007222     ,0.00,3950000,14514436257.29,19081300072220000024,
2005,13/08/2019,13:20:49,13/08/2019,13:20:49,0247 UKT 1107618058 0819/0008219        ,0.00,6400000,14520836257.29,19081300082190000164,
2006,13/08/2019,13:21:43,13/08/2019,13:21:43,0247 UKT 1303617015 0819/0016660        ,0.00,7500000,14528336257.29,19081300166600000063,
2007,13/08/2019,13:21:53,13/08/2019,13:21:53,0247 UKT 1102617027 0819/0012239        ,0.00,3900000,14532236257.29,19081300122390000028,
2008,13/08/2019,13:22:21,13/08/2019,13:22:21,0247 UKT                                ,0.00,6000000,14538236257.29,19081399113810837999,
2009,13/08/2019,13:22:40,13/08/2019,13:22:40,0247 UKT 1205618086 0819/0017768        ,0.00,5900000,14544136257.29,19081300177680000058,
2010,13/08/2019,13:22:50,13/08/2019,13:22:50,0247 UKT 1101617058 0819/0008219        ,0.00,4700000,14548836257.29,19081300082190000166,
2011,13/08/2019,13:24:54,13/08/2019,13:24:54,0247 UKT 1801618038 0819/0011549        ,0.00,4000000,14552836257.29,19081300115490000022,
2012,13/08/2019,13:25:00,13/08/2019,13:25:00,0247 UKT 1939119001702 0819/0008219     ,0.00,3800000,14556636257.29,19081300082190000168,
2013,13/08/2019,13:26:21,13/08/2019,13:26:21,0247 UKT 1801618012 0819/0008219        ,0.00,4000000,14560636257.29,19081300082190000170,
2014,13/08/2019,13:28:09,13/08/2019,13:28:09,0247 UKT 1305618015 0819/0007248        ,0.00,4000000,14564636257.29,19081300072480000075,
2015,13/08/2019,13:28:59,13/08/2019,13:28:59,0247 UKT 1102617044 0819/0016668        ,0.00,3900000,14568536257.29,19081300166680000070,
2016,13/08/2019,13:30:09,13/08/2019,13:30:09,0247 UKT 1207617043 0819/0012936        ,0.00,5900000,14574436257.29,19081300129360000039,
2017,13/08/2019,13:30:28,13/08/2019,13:30:28,0247 UKT 1801617123 0819/0008219        ,0.00,8200000,14582636257.29,19081300082190000174,
2018,13/08/2019,13:31:13,13/08/2019,13:31:13,0247 UKT 1939219003906 0819/0018027     ,0.00,5100000,14587736257.29,19081300180270000045,
2019,13/08/2019,13:32:45,13/08/2019,13:32:45,0247 UKT 1202618003 0819/0008219        ,0.00,6100000,14593836257.29,19081300082190000176,
2020,13/08/2019,13:33:44,13/08/2019,13:33:44,0247 UKT 1202618029 0819/0008219        ,0.00,5900000,14599736257.29,19081300082190000178,
2021,13/08/2019,13:35:22,13/08/2019,13:35:22,0247 UKT 1304617064 0819/0008219        ,0.00,5200000,14604936257.29,19081300082190000180,
2022,13/08/2019,13:36:58,13/08/2019,13:36:58,0247 UKT 1939219010977 0819/0017756     ,0.00,4700000,14609636257.29,19081300177560000050,
2023,13/08/2019,13:37:03,13/08/2019,13:37:03,0247 UKT 1939319000473 0819/0008219     ,0.00,3900000,14613536257.29,19081300082190000182,
2024,13/08/2019,13:37:35,13/08/2019,13:37:35,0247 UKT                                ,0.00,6400000,14619936257.29,19081399113810948996,
2025,13/08/2019,13:38:04,13/08/2019,13:38:04,0247 UKT 1308618034 0819/0013788        ,0.00,4150000,14624086257.29,19081300137880000023,
2026,13/08/2019,13:38:14,13/08/2019,13:38:14,0247 UKT 1939219000833 0819/0016699     ,0.00,3900000,14627986257.29,19081300166990000079,
2027,13/08/2019,13:43:18,13/08/2019,13:43:18,0247 UKT 1103617100 0819/0008219        ,0.00,3000000,14630986257.29,19081300082190000184,
2028,13/08/2019,13:43:30,13/08/2019,13:43:30,0247 UKT 1307618034 0819/0016528        ,0.00,4150000,14635136257.29,19081300165280000031,
2029,13/08/2019,13:44:32,13/08/2019,13:44:32,0247 SPU 1939319000681 0819/0008219     ,0.00,750000,14635886257.29,19081300082190000186,
2030,13/08/2019,13:45:37,13/08/2019,13:45:37,0247 SPU 1939219002099 0819/0008219     ,0.00,1000000,14636886257.29,19081300082190000188,
2031,13/08/2019,13:47:28,13/08/2019,13:47:28,0247 UKT 1801618087 0819/0008219        ,0.00,8200000,14645086257.29,19081300082190000191,
2032,13/08/2019,13:48:31,13/08/2019,13:48:31,0247 UKT 1939319000920 0819/0017990     ,0.00,5100000,14650186257.29,19081300179900000048,
2033,13/08/2019,13:49:17,13/08/2019,13:49:17,0247 UKT 1801618076 0819/0013469        ,0.00,4000000,14654186257.29,19081300134690000087,
2034,13/08/2019,13:50:36,13/08/2019,13:50:36,0247 UKT 1103618010 0819/0006789        ,0.00,3000000,14657186257.29,19081300067890000025,
2035,13/08/2019,13:51:11,13/08/2019,13:51:11,0247 UKT 1202618008 0819/0008554        ,0.00,3900000,14661086257.29,19081300085540000082,
2036,13/08/2019,13:52:12,13/08/2019,13:52:12,0247 UKT 1211617003 0819/0008219        ,0.00,5600000,14666686257.29,19081300082190000195,
2037,13/08/2019,13:52:35,13/08/2019,13:52:35,0247 UKT 1939219006181 0819/0008554     ,0.00,4000000,14670686257.29,19081300085540000084,
2038,13/08/2019,13:53:32,13/08/2019,13:53:32,0247 UKT                                ,0.00,5200000,14675886257.29,19081399276010066490,
2039,13/08/2019,13:53:47,13/08/2019,13:53:47,0247 UKT 1308618046 0819/0008219        ,0.00,6250000,14682136257.29,19081300082190000197,
2040,13/08/2019,13:59:31,13/08/2019,13:59:31,0247 SPU 1939219014847 0819/0005992     ,0.00,2000000,14684136257.29,19081300059920000029,
2041,13/08/2019,14:00:27,13/08/2019,14:00:27,0247 UKT 1939219000796 0819/0008237     ,0.00,2700000,14686836257.29,19081300082370000031,
2042,13/08/2019,14:01:35,13/08/2019,14:01:35,0247 UKT 1301618034 0819/0009602        ,0.00,3800000,14690636257.29,19081300096020000056,
2043,13/08/2019,14:04:20,13/08/2019,14:04:20,0247 UKT 1939219007613 0819/0008219     ,0.00,1000000,14691636257.29,19081300082190000199,
2044,13/08/2019,14:04:42,13/08/2019,14:04:42,0247 SPU 1939219007613 0819/0008219     ,0.00,5000000,14696636257.29,19081300082190000201,
2045,13/08/2019,14:04:48,13/08/2019,14:04:48,0247 UKT 1939319000753 0819/0016490     ,0.00,3000000,14699636257.29,19081300164900000051,
2046,13/08/2019,14:04:52,13/08/2019,14:04:52,0247 UKT 1204618024 0819/0012485        ,0.00,6100000,14705736257.29,19081300124850000049,
2047,13/08/2019,14:06:21,13/08/2019,14:06:21,0247 UKT 1939119003530 0819/0008219     ,0.00,1000000,14706736257.29,19081300082190000205,
2048,13/08/2019,14:07:57,13/08/2019,14:07:57,0247 UKT 1210617005 0819/0008219        ,0.00,5500000,14712236257.29,19081300082190000207,
2049,13/08/2019,14:08:55,13/08/2019,14:08:55,0247 UKT 1306618002 0819/0008219        ,0.00,1000000,14713236257.29,19081300082190000209,
2050,13/08/2019,14:09:03,13/08/2019,14:09:03,0247 UKT 1308618024 0819/0006664        ,0.00,6250000,14719486257.29,19081300066640000041,
2051,13/08/2019,14:10:28,13/08/2019,14:10:28,0247 UKT 1206617025 0819/0018020        ,0.00,4500000,14723986257.29,19081300180200000047,
2052,13/08/2019,14:11:32,13/08/2019,14:11:32,0247 UKT 1105618018 0819/0006459        ,0.00,3900000,14727886257.29,19081300064590000047,
2053,13/08/2019,14:11:52,13/08/2019,14:11:52,0247 UKT 1939219006507 0819/0016717     ,0.00,3000000,14730886257.29,19081300167170000035,
2054,13/08/2019,14:15:57,13/08/2019,14:15:57,0247 UKT 1208617042 0819/0018024        ,0.00,6700000,14737586257.29,19081300180240000053,
2055,13/08/2019,14:19:21,13/08/2019,14:19:21,0247 UKT 1939219015189 0819/0008225     ,0.00,4000000,14741586257.29,19081300082250000026,
2056,13/08/2019,14:21:50,13/08/2019,14:21:50,0247 UKT 1939219015858 0819/0010960     ,0.00,4500000,14746086257.29,19081300109600000055,
2057,13/08/2019,14:23:35,13/08/2019,14:23:35,0247 UKT 1206618031 0819/0009659        ,0.00,6700000,14752786257.29,19081300096590000063,
2058,13/08/2019,14:23:51,13/08/2019,14:23:51,0247 UKT 1939219014565 0819/0017011     ,0.00,3000000,14755786257.29,19081300170110000085,
2059,13/08/2019,14:24:06,13/08/2019,14:24:06,0247 UKT 1939219011792 0819/0010960     ,0.00,4600000,14760386257.29,19081300109600000057,
2060,13/08/2019,14:25:28,13/08/2019,14:25:28,0247 UKT 1939219016242 0819/0016720     ,0.00,3900000,14764286257.29,19081300167200000069,
2061,13/08/2019,14:31:59,13/08/2019,14:31:59,0247 UKT 1603617125 0819/0018027        ,0.00,7600000,14771886257.29,19081300180270000049,
2062,13/08/2019,14:32:25,13/08/2019,14:32:25,0247 UKT 1107618057 0819/0008219        ,0.00,3000000,14774886257.29,19081300082190000211,
2063,13/08/2019,14:32:39,13/08/2019,14:32:39,0247 UKT 1303618064 0819/0017993        ,0.00,3950000,14778836257.29,19081300179930000046,
2064,13/08/2019,14:33:44,13/08/2019,14:33:44,0247 UKT 1107617035 0819/0007759        ,0.00,5100000,14783936257.29,19081300077590000050,
2065,13/08/2019,14:33:48,13/08/2019,14:33:48,0247 SPU 1939119001580 0819/0008219     ,0.00,750000,14784686257.29,19081300082190000213,
2066,13/08/2019,14:34:55,13/08/2019,14:34:55,0247 UKT 1939219014009 0819/0009756     ,0.00,6202000,14790888257.29,19081300097560000060,
2067,13/08/2019,14:40:29,13/08/2019,14:40:29,0247 UKT 1303617020 0819/0008219        ,0.00,6200000,14797088257.29,19081300082190000215,
2068,13/08/2019,14:41:45,13/08/2019,14:41:45,0247 UKT 1939219004992 0819/0008219     ,0.00,6000000,14803088257.29,19081300082190000217,
2069,13/08/2019,14:42:04,13/08/2019,14:42:04,0247 SPU 1939219004992 0819/0008219     ,0.00,750000,14803838257.29,19081300082190000219,
2070,13/08/2019,14:44:16,13/08/2019,14:44:16,0247 UKT 1204618019 0819/0008219        ,0.00,3900000,14807738257.29,19081300082190000221,
2071,13/08/2019,14:47:14,13/08/2019,14:47:14,0247 UKT 1207618029 0819/0016654        ,0.00,4500000,14812238257.29,19081300166540000035,
2072,13/08/2019,14:49:03,13/08/2019,14:49:03,0247 UKT 1106618013 0819/0008214        ,0.00,5100000,14817338257.29,19081300082140000072,
2073,13/08/2019,14:51:35,13/08/2019,14:51:35,0247 UKT 1602617082 0819/0006459        ,0.00,2700000,14820038257.29,19081300064590000053,
2074,13/08/2019,14:53:35,13/08/2019,14:53:35,0247 UKT 1602617023 0819/0016561        ,0.00,4700000,14824738257.29,19081300165610000059,
2075,13/08/2019,14:55:27,13/08/2019,14:55:27,0247 UKT 1939219007491 0819/0013066     ,0.00,5900000,14830638257.29,19081300130660000105,
2076,13/08/2019,14:57:04,13/08/2019,14:57:04,0247 SPU 1939219007491 0819/0013066     ,0.00,1000000,14831638257.29,19081300130660000107,
2077,13/08/2019,15:01:18,13/08/2019,15:01:18,0247 UKT 1939119002362 0819/0011932     ,0.00,3950000,14835588257.29,19081300119320000027,
2078,13/08/2019,15:02:00,13/08/2019,15:02:00,0247 UKT                                ,0.00,6200000,14841788257.29,19081399101310569465,
2079,13/08/2019,15:08:06,13/08/2019,15:08:06,0247 UKT 1939119003588 0819/0013519     ,0.00,1000000,14842788257.29,19081300135190000202,
2080,13/08/2019,15:08:50,13/08/2019,15:08:50,0247 SPU 1939119003588 0819/0013519     ,0.00,750000,14843538257.29,19081300135190000205,
2081,13/08/2019,15:12:28,13/08/2019,15:12:28,0247 UKT 1939219016322 0819/0008219     ,0.00,6700000,14850238257.29,19081300082190000230,
2082,13/08/2019,15:12:49,13/08/2019,15:12:49,0247 SPU 1939219016322 0819/0008219     ,0.00,1000000,14851238257.29,19081300082190000232,
2083,13/08/2019,16:08:45,13/08/2019,16:08:45,0247 UKT                                ,0.00,5200000,14856438257.29,19081399614010046547,
2084,13/08/2019,16:24:42,13/08/2019,16:24:42,0247 UKT                                ,0.00,5100000,14861538257.29,19081399201010168357,
2085,13/08/2019,16:34:13,13/08/2019,16:34:13,0247 UKT                                ,0.00,6700000,14868238257.29,19081399113810245153,
2086,13/08/2019,17:18:42,13/08/2019,17:18:42,0247 UKT                                ,0.00,5900000,14874138257.29,19081399113810577994,
2087,13/08/2019,18:36:45,13/08/2019,18:36:45,0247 UKT                                ,0.00,1000000,14875138257.29,19081399293010146148,
2088,13/08/2019,19:56:33,13/08/2019,19:56:33,0247 UKT                                ,0.00,3000000,14878138257.29,19081399308010757856,
2089,14/08/2019,07:34:09,14/08/2019,07:34:09,0247 UKT                                ,0.00,6700000,14884838257.29,19081499291010408770,
2090,14/08/2019,08:05:26,14/08/2019,08:05:26,0247 UKT 1301617005 0819/0008244        ,0.00,6000000,14890838257.29,19081400082440000002,
2091,14/08/2019,08:07:09,14/08/2019,08:07:09,0247 UKT 1939219009305 0819/0008219     ,0.00,3900000,14894738257.29,19081400082190000002,
2092,14/08/2019,08:07:34,14/08/2019,08:07:34,0247 SPU 1939219009305 0819/0008219     ,0.00,750000,14895488257.29,19081400082190000004,
2093,14/08/2019,08:08:50,14/08/2019,08:08:50,0247 UKT 1602617171 0819/0010403        ,0.00,2700000,14898188257.29,19081400104030000008,
2094,14/08/2019,08:09:56,14/08/2019,08:09:56,0247 UKT 1939219005486 0819/0008219     ,0.00,6700000,14904888257.29,19081400082190000006,
2095,14/08/2019,08:11:03,14/08/2019,08:11:03,0247 UKT 1308618038 0819/0013436        ,0.00,4150000,14909038257.29,19081400134360000002,
2096,14/08/2019,08:12:55,14/08/2019,08:12:55,0247 UKT 1304617010 0819/0016723        ,0.00,3950000,14912988257.29,19081400167230000002,
2097,14/08/2019,08:15:50,14/08/2019,08:15:50,0247 SPU 1939219016161 0819/0018000     ,0.00,1000000,14913988257.29,19081400180000000002,
2098,14/08/2019,08:17:53,14/08/2019,08:17:53,0247 UKT 1939219011662 0819/0009574     ,0.00,4600000,14918588257.29,19081400095740000004,
2099,14/08/2019,08:23:04,14/08/2019,08:23:04,0247 UKT 1211618007 0819/0008219        ,0.00,5600000,14924188257.29,19081400082190000008,
2100,14/08/2019,08:25:57,14/08/2019,08:25:57,0247 UKT 1201617067 0819/0010960        ,0.00,4000000,14928188257.29,19081400109600000004,
2101,14/08/2019,08:26:38,14/08/2019,08:26:38,0247 UKT 1801617294 0819/0016612        ,0.00,8200000,14936388257.29,19081400166120000006,
2102,14/08/2019,08:28:29,14/08/2019,08:28:29,0247 UKT 1302618048 0819/0013791        ,0.00,3800000,14940188257.29,19081400137910000018,
2103,14/08/2019,08:29:03,14/08/2019,08:29:03,0247 UKT 1939219011997 0819/0007346     ,0.00,6700000,14946888257.29,19081400073460000002,
2104,14/08/2019,08:29:47,14/08/2019,08:29:47,0247 SPU 1939219011997 0819/0007346     ,0.00,1000000,14947888257.29,19081400073460000005,
2105,14/08/2019,08:32:02,14/08/2019,08:32:02,0247 UKT 1308618052 0819/0008219        ,0.00,4150000,14952038257.29,19081400082190000010,
2106,14/08/2019,08:32:19,14/08/2019,08:32:19,0247 UKT 1801617153 0819/0013471        ,0.00,4000000,14956038257.29,19081400134710000005,
2107,14/08/2019,08:34:48,14/08/2019,08:34:48,0247 UKT 1939219007000 0819/0008219     ,0.00,5100000,14961138257.29,19081400082190000012,
2108,14/08/2019,08:35:13,14/08/2019,08:35:13,0247 UKT 1201618051 0819/0016484        ,0.00,4000000,14965138257.29,19081400164840000020,
2109,14/08/2019,08:38:40,14/08/2019,08:38:40,0247 UKT 1304618057 0819/0013048        ,0.00,3950000,14969088257.29,19081400130480000039,
2110,14/08/2019,08:39:45,14/08/2019,08:39:45,0247 UKT 1939219014850 0819/0008219     ,0.00,4000000,14973088257.29,19081400082190000014,
2111,14/08/2019,08:40:04,14/08/2019,08:40:04,0247 SPU 1939219014850 0819/0008219     ,0.00,1000000,14974088257.29,19081400082190000016,
2112,14/08/2019,08:41:42,14/08/2019,08:41:42,0247 UKT 1939219014422 0819/0008219     ,0.00,500000,14974588257.29,19081400082190000018,
2113,14/08/2019,08:46:03,14/08/2019,08:46:03,0247 UKT 1939219014741 0819/0013498     ,0.00,8200000,14982788257.29,19081400134980000002,
2114,14/08/2019,08:46:53,14/08/2019,08:46:53,0247 UKT 1939319000367 0819/0013470     ,0.00,3200000,14985988257.29,19081400134700000004,
2115,14/08/2019,08:47:29,14/08/2019,08:47:29,0247 UKT 1102618056 0819/0008219        ,0.00,4500000,14990488257.29,19081400082190000022,
2116,14/08/2019,08:49:16,14/08/2019,08:49:16,0247 SPU 1939319000367 0819/0013470     ,0.00,1000000,14991488257.29,19081400134700000006,
2117,14/08/2019,08:49:58,14/08/2019,08:49:58,0247 UKT 1801618141 0819/0012487        ,0.00,10300000,15001788257.29,19081400124870000008,
2118,14/08/2019,08:58:30,14/08/2019,08:58:30,0247 SPU 1939219011360 0819/0013048     ,0.00,800000,15002588257.29,19081400130480000051,
2119,14/08/2019,08:58:49,14/08/2019,08:58:49,0247 UKT 1939219011360 0819/0013048     ,0.00,3900000,15006488257.29,19081400130480000053,
2120,14/08/2019,08:59:02,14/08/2019,08:59:02,0247 SPU 1939219003684 0819/0007168     ,0.00,750000,15007238257.29,19081400071680000069,
2121,14/08/2019,08:59:26,14/08/2019,08:59:26,0247 UKT 1939219003684 0819/0007168     ,0.00,5100000,15012338257.29,19081400071680000071,
2122,14/08/2019,09:01:39,14/08/2019,09:01:39,0247 UKT 1939219013531 0819/0018138     ,0.00,8200000,15020538257.29,19081400181380000004,
2123,14/08/2019,09:01:52,14/08/2019,09:01:52,0247 UKT 1210617039 0819/0018139        ,0.00,4600000,15025138257.29,19081400181390000004,
2124,14/08/2019,09:02:25,14/08/2019,09:02:25,0247 UKT 1303618035 0819/0018025        ,0.00,6200000,15031338257.29,19081400180250000005,
2125,14/08/2019,09:03:11,14/08/2019,09:03:11,0247 UKT 1207618009 0819/0017006        ,0.00,7100000,15038438257.29,19081400170060000012,
2126,14/08/2019,09:03:41,14/08/2019,09:03:41,0247 UKT 1602617074 0819/0008594        ,0.00,4700000,15043138257.29,19081400085940000003,
2127,14/08/2019,09:03:52,14/08/2019,09:03:52,0247 UKT 1939219013937 0819/0008219     ,0.00,1000000,15044138257.29,19081400082190000024,
2128,14/08/2019,09:04:15,14/08/2019,09:04:15,0247 SPU 1939219013531 0819/0018138     ,0.00,15000000,15059138257.29,19081400181380000007,
2129,14/08/2019,09:04:22,14/08/2019,09:04:22,0247 UKT 1104617109 0819/0008941        ,0.00,6700000,15065838257.29,19081400089410000009,
2130,14/08/2019,09:05:23,14/08/2019,09:05:23,0247 UKT 1208618020 0819/0009620        ,0.00,6700000,15072538257.29,19081400096200000022,
2131,14/08/2019,09:09:07,14/08/2019,09:09:07,0247 UKT 1302617065 0819/0008574        ,0.00,7000000,15079538257.29,19081400085740000006,
2132,14/08/2019,09:12:04,14/08/2019,09:12:04,0247 UKT 1305617015 0819/0008219        ,0.00,4000000,15083538257.29,19081400082190000026,
2133,14/08/2019,09:14:52,14/08/2019,09:14:52,0247 UKT 1939219004090 0819/0016708     ,0.00,5400000,15088938257.29,19081400167080000020,
2134,14/08/2019,09:15:18,14/08/2019,09:15:18,0247 SPU 1939219004090 0819/0016708     ,0.00,1000000,15089938257.29,19081400167080000022,
2135,14/08/2019,09:16:13,14/08/2019,09:16:13,0247 UKT 1303617071 0819/0007348        ,0.00,7500000,15097438257.29,19081400073480000002,
2136,14/08/2019,09:17:46,14/08/2019,09:17:46,0247 UKT 1303617066 0819/0007168        ,0.00,3950000,15101388257.29,19081400071680000075,
2137,14/08/2019,09:23:15,14/08/2019,09:23:15,0247 UKT 1208617041 0819/0013087        ,0.00,6700000,15108088257.29,19081400130870000008,
2138,14/08/2019,09:26:26,14/08/2019,09:26:26,0247 UKT 1939219007921 0819/0018003     ,0.00,1000000,15109088257.29,19081400180030000009,
2139,14/08/2019,09:28:06,14/08/2019,09:28:06,0247 UKT 1107617183 0819/0008219        ,0.00,5100000,15114188257.29,19081400082190000028,
2140,14/08/2019,09:30:22,14/08/2019,09:30:22,0247 SPU 1939119002967 0819/0007901     ,0.00,5000000,15119188257.29,19081400079010000015,
2141,14/08/2019,09:30:47,14/08/2019,09:30:47,0247 UKT 1939119002967 0819/0007901     ,0.00,4000000,15123188257.29,19081400079010000017,
2142,14/08/2019,09:32:44,14/08/2019,09:32:44,0247 UKT 1206617019 0819/0008219        ,0.00,6700000,15129888257.29,19081400082190000041,
2143,14/08/2019,09:35:45,14/08/2019,09:35:45,0247 UKT 1939219014425 0819/0017989     ,0.00,3900000,15133788257.29,19081400179890000022,
2144,14/08/2019,09:39:25,14/08/2019,09:39:25,0247 UKT 1101617026 0819/0017002        ,0.00,5300000,15139088257.29,19081400170020000023,
2145,14/08/2019,09:39:25,14/08/2019,09:39:25,0247 UKT 1801618167 0819/0012233        ,0.00,8200000,15147288257.29,19081400122330000018,
2146,14/08/2019,09:49:32,14/08/2019,09:49:32,0247 SPU 1939219005928 0819/0007887     ,0.00,750000,15148038257.29,19081400078870000034,
2147,14/08/2019,09:50:00,14/08/2019,09:50:00,0247 UKT 1939219011284 0819/0008547     ,0.00,3000000,15151038257.29,19081400085470000006,
2148,14/08/2019,09:50:46,14/08/2019,09:50:46,0247 UKT 1939219005928 0819/0007887     ,0.00,6700000,15157738257.29,19081400078870000036,
2149,14/08/2019,09:51:48,14/08/2019,09:51:48,0247 UKT 1301617069 0819/0008588        ,0.00,9000000,15166738257.29,19081400085880000027,
2150,14/08/2019,09:54:59,14/08/2019,09:54:59,0247 UKT 1107618145 0819/0008186        ,0.00,3000000,15169738257.29,19081400081860000033,
2151,14/08/2019,09:56:37,14/08/2019,09:56:37,0247 UKT 1939119002290 0819/0013497     ,0.00,4000000,15173738257.29,19081400134970000018,
2152,14/08/2019,09:57:55,14/08/2019,09:57:55,0247 UKT 1308617019 0819/0018018        ,0.00,6250000,15179988257.29,19081400180180000013,
2153,14/08/2019,10:00:40,14/08/2019,10:00:40,0247 UKT 1939219012366 0819/0008219     ,0.00,4500000,15184488257.29,19081400082190000043,
2154,14/08/2019,10:01:17,14/08/2019,10:01:17,0247 UKT 1102617077 0819/0017017        ,0.00,1000000,15185488257.29,19081400170170000010,
2155,14/08/2019,10:01:17,14/08/2019,10:01:17,0247 UKT 1101617091 0819/0011952        ,0.00,3000000,15188488257.29,19081400119520000016,
2156,14/08/2019,10:04:28,14/08/2019,10:04:28,0247 UKT 1939119002757 0819/0008219     ,0.00,3950000,15192438257.29,19081400082190000045,
2157,14/08/2019,10:04:57,14/08/2019,10:04:57,0247 UKT 1302617067 0819/0017768        ,0.00,3800000,15196238257.29,19081400177680000011,
2158,14/08/2019,10:06:36,14/08/2019,10:06:36,0247 UKT                                ,0.00,4500000,15200738257.29,19081499274010522452,
2159,14/08/2019,10:08:16,14/08/2019,10:08:16,0247 UKT 1602618053 0819/0009772        ,0.00,4700000,15205438257.29,19081400097720000040,
2160,14/08/2019,10:09:58,14/08/2019,10:09:58,0247 UKT 1939119003724 0819/0008244     ,0.00,4150000,15209588257.29,19081400082440000018,
2161,14/08/2019,10:11:35,14/08/2019,10:11:35,0247 UKT 1203617053 0819/0013436        ,0.00,5600000,15215188257.29,19081400134360000039,
2162,14/08/2019,10:11:59,14/08/2019,10:11:59,0247 UKT 1302617011 0819/0016657        ,0.00,1000000,15216188257.29,19081400166570000028,
2163,14/08/2019,10:14:32,14/08/2019,10:14:32,0247 UKT 1801618008 0819/0013497        ,0.00,6200000,15222388257.29,19081400134970000022,
2164,14/08/2019,10:16:47,14/08/2019,10:16:47,0247 UKT 1304618053 0819/0012476        ,0.00,6200000,15228588257.29,19081400124760000019,
2165,14/08/2019,10:18:41,14/08/2019,10:18:41,0247 UKT 1939119003044 0819/0008219     ,0.00,4000000,15232588257.29,19081400082190000047,
2166,14/08/2019,10:19:03,14/08/2019,10:19:03,0247 SPU 1939119003044 0819/0008219     ,0.00,750000,15233338257.29,19081400082190000049,
2167,14/08/2019,10:20:42,14/08/2019,10:20:42,0247 UKT 1107617199 0819/0008253        ,0.00,3000000,15236338257.29,19081400082530000004,
2168,14/08/2019,10:20:57,14/08/2019,10:20:57,0247 UKT 1604618035 0819/0008219        ,0.00,3200000,15239538257.29,19081400082190000051,
2169,14/08/2019,10:21:17,14/08/2019,10:21:17,0247 UKT 1107617271 0819/0008574        ,0.00,3900000,15243438257.29,19081400085740000021,
2170,14/08/2019,10:22:21,14/08/2019,10:22:21,0247 UKT 1602617030 0819/0008214        ,0.00,5700000,15249138257.29,19081400082140000009,
2171,14/08/2019,10:22:41,14/08/2019,10:22:41,0247 SPU 1939119000898 0819/0008219     ,0.00,1000000,15250138257.29,19081400082190000053,
2172,14/08/2019,10:22:52,14/08/2019,10:22:52,0247 UKT 1939219000496 0819/0016619     ,0.00,4700000,15254838257.29,19081400166190000020,
2173,14/08/2019,10:24:55,14/08/2019,10:24:55,0247 SPU 1939119000922 0819/0008219     ,0.00,750000,15255588257.29,19081400082190000055,
2174,14/08/2019,10:25:53,14/08/2019,10:25:53,0247 UKT 1206617057 0819/0009627        ,0.00,6700000,15262288257.29,19081400096270000016,
2175,14/08/2019,10:26:03,14/08/2019,10:26:03,0247 UKT 1939219012971 0819/0011829     ,0.00,6400000,15268688257.29,19081400118290000025,
2176,14/08/2019,10:26:44,14/08/2019,10:26:44,0247 UKT 1603617111 0819/0006168        ,0.00,6500000,15275188257.29,19081400061680000022,
2177,14/08/2019,10:27:08,14/08/2019,10:27:08,0247 SPU 1939219012971 0819/0011829     ,0.00,1000000,15276188257.29,19081400118290000029,
2178,14/08/2019,10:28:43,14/08/2019,10:28:43,0247 UKT 1314617025 0819/0005992        ,0.00,4000000,15280188257.29,19081400059920000004,
2179,14/08/2019,10:30:08,14/08/2019,10:30:08,0247 UKT 1304617011 0819/0010977        ,0.00,6200000,15286388257.29,19081400109770000006,
2180,14/08/2019,10:30:59,14/08/2019,10:30:59,0247 UKT 1939219009539 0819/0008219     ,0.00,6700000,15293088257.29,19081400082190000057,
2181,14/08/2019,10:31:09,14/08/2019,10:31:09,0247 UKT 1939119000899 0819/0016716     ,0.00,4500000,15297588257.29,19081400167160000017,
2182,14/08/2019,10:31:19,14/08/2019,10:31:19,0247 UKT 1801618082 0819/0008298        ,0.00,8200000,15305788257.29,19081400082980000005,
2183,14/08/2019,10:31:21,14/08/2019,10:31:21,0247 SPU 1939219009539 0819/0008219     ,0.00,10000000,15315788257.29,19081400082190000059,
2184,14/08/2019,10:31:31,14/08/2019,10:31:31,0247 UKT 1939119000140 0819/0006635     ,0.00,3200000,15318988257.29,19081400066350000044,
2185,14/08/2019,10:33:36,14/08/2019,10:33:36,0247 UKT 1939119001604 0819/0008219     ,0.00,500000,15319488257.29,19081400082190000061,
2186,14/08/2019,10:34:08,14/08/2019,10:34:08,0247 UKT 1801617211 0819/0017017        ,0.00,8200000,15327688257.29,19081400170170000014,
2187,14/08/2019,10:36:09,14/08/2019,10:36:09,0247 UKT 1602617083 0819/0008941        ,0.00,4700000,15332388257.29,19081400089410000027,
2188,14/08/2019,10:37:11,14/08/2019,10:37:11,0247 UKT 1211617022 0819/0008219        ,0.00,1000000,15333388257.29,19081400082190000063,
2189,14/08/2019,10:38:00,14/08/2019,10:38:00,0247 UKT 1107617115 0819/0007367        ,0.00,5100000,15338488257.29,19081400073670000002,
2190,14/08/2019,10:39:05,14/08/2019,10:39:05,0247 UKT 1211617016 0819/0008219        ,0.00,5900000,15344388257.29,19081400082190000065,
2191,14/08/2019,10:39:07,14/08/2019,10:39:07,0247 UKT 1102617105 0819/0008244        ,0.00,3900000,15348288257.29,19081400082440000020,
2192,14/08/2019,10:43:11,14/08/2019,10:43:11,0247 UKT 1939219010172 0819/0008219     ,0.00,4500000,15352788257.29,19081400082190000067,
2193,14/08/2019,10:43:29,14/08/2019,10:43:29,0247 SPU 1939219010172 0819/0008219     ,0.00,750000,15353538257.29,19081400082190000069,
2194,14/08/2019,10:43:34,14/08/2019,10:43:34,0247 UKT 1602617209 0819/0016529        ,0.00,4700000,15358238257.29,19081400165290000059,
2195,14/08/2019,10:45:31,14/08/2019,10:45:31,0247 UKT 1301617034 0819/0013442        ,0.00,3800000,15362038257.29,19081400134420000023,
2196,14/08/2019,10:45:42,14/08/2019,10:45:42,0247 UKT 1101617016 0819/0008219        ,0.00,5300000,15367338257.29,19081400082190000071,
2197,14/08/2019,10:47:01,14/08/2019,10:47:01,0247 UKT 1304617029 0819/0010517        ,0.00,3950000,15371288257.29,19081400105170000050,
2198,14/08/2019,10:47:03,14/08/2019,10:47:03,0247 UKT 1302617014 0819/0016541        ,0.00,3800000,15375088257.29,19081400165410000026,
2199,14/08/2019,10:47:13,14/08/2019,10:47:13,0247 UKT 1105618069 0819/0013436        ,0.00,5100000,15380188257.29,19081400134360000065,
2200,14/08/2019,10:49:24,14/08/2019,10:49:24,0247 UKT 1302617047 0819/0016699        ,0.00,3800000,15383988257.29,19081400166990000042,
2201,14/08/2019,10:52:52,14/08/2019,10:52:52,0247 UKT 1102618038 0819/0009627        ,0.00,5100000,15389088257.29,19081400096270000021,
2202,14/08/2019,10:53:36,14/08/2019,10:53:36,0247 UKT 1301617057 0819/0013724        ,0.00,7000000,15396088257.29,19081400137240000039,
2203,14/08/2019,10:55:50,14/08/2019,10:55:50,0247 UKT 1313618003 0819/0013069        ,0.00,4000000,15400088257.29,19081400130690000063,
2204,14/08/2019,10:59:07,14/08/2019,10:59:07,0247 UKT 1301617074 0819/0018007        ,0.00,3800000,15403888257.29,19081400180070000015,
2205,14/08/2019,11:00:37,14/08/2019,11:00:37,0247 UKT 1308617062 0819/0013497        ,0.00,6250000,15410138257.29,19081400134970000029,
2206,14/08/2019,11:00:42,14/08/2019,11:00:42,0247 UKT 1201618011 0819/0008219        ,0.00,6000000,15416138257.29,19081400082190000073,
2207,14/08/2019,11:10:07,14/08/2019,11:10:07,0247 UKT 1939319000974 0819/0008219     ,0.00,5600000,15421738257.29,19081400082190000075,
2208,14/08/2019,11:10:26,14/08/2019,11:10:26,0247 SPU 1939319000974 0819/0008219     ,0.00,1000000,15422738257.29,19081400082190000077,
2209,14/08/2019,11:13:05,14/08/2019,11:13:05,0247 UKT 1801617044 0819/0008219        ,0.00,7200000,15429938257.29,19081400082190000079,
2210,14/08/2019,11:13:08,14/08/2019,11:13:08,0247 UKT 1103618062 0819/0016584        ,0.00,4000000,15433938257.29,19081400165840000112,
2211,14/08/2019,11:14:28,14/08/2019,11:14:28,0247 UKT 1205618023 0819/0008219        ,0.00,3900000,15437838257.29,19081400082190000081,
2212,14/08/2019,11:16:45,14/08/2019,11:16:45,0247 UKT 1601618084 0819/0009569        ,0.00,5700000,15443538257.29,19081400095690000115,
2213,14/08/2019,11:16:46,14/08/2019,11:16:46,0247 UKT 1106617042 0819/0013056        ,0.00,6400000,15449938257.29,19081400130560000014,
2214,14/08/2019,11:17:34,14/08/2019,11:17:34,0247 UKT 1801618124 0819/0008219        ,0.00,10300000,15460238257.29,19081400082190000083,
2215,14/08/2019,11:18:01,14/08/2019,11:18:01,0247 UKT 1107617207 0819/0013799        ,0.00,5100000,15465338257.29,19081400137990000060,
2216,14/08/2019,11:18:19,14/08/2019,11:18:19,0247 UKT 1308617038 0819/0008246        ,0.00,5250000,15470588257.29,19081400082460000076,
2217,14/08/2019,11:19:47,14/08/2019,11:19:47,0247 UKT 1209617061 0819/0013063        ,0.00,4500000,15475088257.29,19081400130630000020,
2218,14/08/2019,11:20:01,14/08/2019,11:20:01,0247 UKT 1107618042 0819/0008219        ,0.00,3000000,15478088257.29,19081400082190000085,
2219,14/08/2019,11:20:25,14/08/2019,11:20:25,0247 UKT 1939219011764 0819/0009772     ,0.00,8200000,15486288257.29,19081400097720000063,
2220,14/08/2019,11:21:14,14/08/2019,11:21:14,0247 SPU 1939219011764 0819/0009772     ,0.00,750000,15487038257.29,19081400097720000065,
2221,14/08/2019,11:21:25,14/08/2019,11:21:25,0247 UKT 1107618019 0819/0008219        ,0.00,4500000,15491538257.29,19081400082190000087,
2222,14/08/2019,11:22:16,14/08/2019,11:22:16,0247 UKT 1107617240 0819/0008219        ,0.00,3900000,15495438257.29,19081400082190000089,
2223,14/08/2019,11:22:56,14/08/2019,11:22:56,0247 UKT 1304618045 0819/0008219        ,0.00,500000,15495938257.29,19081400082190000091,
2224,14/08/2019,11:25:51,14/08/2019,11:25:51,0247 UKT 1213617006 0819/0008219        ,0.00,500000,15496438257.29,19081400082190000095,
2225,14/08/2019,11:26:49,14/08/2019,11:26:49,0247 UKT 1301617070 0819/0008547        ,0.00,3800000,15500238257.29,19081400085470000013,
2226,14/08/2019,11:27:39,14/08/2019,11:27:39,0247 SPU 1939219000944 0819/0007887     ,0.00,1000000,15501238257.29,19081400078870000071,
2227,14/08/2019,11:28:25,14/08/2019,11:28:25,0247 UKT 1939219000944 0819/0007887     ,0.00,10300000,15511538257.29,19081400078870000073,
2228,14/08/2019,11:28:45,14/08/2019,11:28:45,0247 UKT 1301618021 0819/0007900        ,0.00,6000000,15517538257.29,19081400079000000011,
2229,14/08/2019,11:29:48,14/08/2019,11:29:48,0247 UKT 1304617074 0819/0013482        ,0.00,4500000,15522038257.29,19081400134820000029,
2230,14/08/2019,11:31:49,14/08/2019,11:31:49,0247 UKT 1207617048 0819/0007168        ,0.00,500000,15522538257.29,19081400071680000126,
2231,14/08/2019,11:36:13,14/08/2019,11:36:13,0247 UKT 1601617071 0819/0008298        ,0.00,2700000,15525238257.29,19081400082980000011,
2232,14/08/2019,11:40:08,14/08/2019,11:40:08,0247 UKT 1303617075 0819/0013062        ,0.00,3950000,15529188257.29,19081400130620000045,
2233,14/08/2019,11:43:08,14/08/2019,11:43:08,0247 UKT 1939219016224 0819/0016490     ,0.00,4500000,15533688257.29,19081400164900000029,
2234,14/08/2019,11:43:36,14/08/2019,11:43:36,0247 UKT 1602618027 0819/0016716        ,0.00,4700000,15538388257.29,19081400167160000029,
2235,14/08/2019,11:45:04,14/08/2019,11:45:04,0247 UKT 1201617039 0819/0013439        ,0.00,4700000,15543088257.29,19081400134390000021,
2236,14/08/2019,11:58:31,14/08/2019,11:58:31,0247 UKT 1801618080 0819/0009627        ,0.00,4000000,15547088257.29,19081400096270000027,
2237,14/08/2019,11:59:02,14/08/2019,11:59:02,0247 UKT 1206617047 0819/0016722        ,0.00,4500000,15551588257.29,19081400167220000028,
2238,14/08/2019,12:00:32,14/08/2019,12:00:32,0247 SPU 1939119002290 0819/0008219     ,0.00,2000000,15553588257.29,19081400082190000099,
2239,14/08/2019,12:01:46,14/08/2019,12:01:46,0247 UKT 1106618056 0819/0008548        ,0.00,3000000,15556588257.29,19081400085480000081,
2240,14/08/2019,12:02:14,14/08/2019,12:02:14,0247 UKT 1801617010 0819/0008219        ,0.00,4000000,15560588257.29,19081400082190000101,
2241,14/08/2019,12:04:17,14/08/2019,12:04:17,0247 UKT 1801617240 0819/0008219        ,0.00,6200000,15566788257.29,19081400082190000103,
2242,14/08/2019,12:07:32,14/08/2019,12:07:32,0247 UKT 1939219016504 0819/0008219     ,0.00,3000000,15569788257.29,19081400082190000105,
2243,14/08/2019,12:08:57,14/08/2019,12:08:57,0247 UKT 1107617186 0819/0008219        ,0.00,1000000,15570788257.29,19081400082190000107,
2244,14/08/2019,12:09:55,14/08/2019,12:09:55,0247 UKT 1604618019 0819/0011540        ,0.00,6500000,15577288257.29,19081400115400000008,
2245,14/08/2019,12:10:00,14/08/2019,12:10:00,0247 UKT 1301617065 0819/0012882        ,0.00,3800000,15581088257.29,19081400128820000036,
2246,14/08/2019,12:13:28,14/08/2019,12:13:28,0247 UKT 1603617109 0819/0017987        ,0.00,1000000,15582088257.29,19081400179870000073,
2247,14/08/2019,12:37:48,14/08/2019,12:37:48,0247 UKT 1939219016769 0819/0008573     ,0.00,4500000,15586588257.29,19081400085730000019,
2248,14/08/2019,12:38:53,14/08/2019,12:38:53,0247 SPU 1939219016769 0819/0008573     ,0.00,750000,15587338257.29,19081400085730000022,
2249,14/08/2019,12:42:31,14/08/2019,12:42:31,0247 UKT 1205617073 0819/0016621        ,0.00,4500000,15591838257.29,19081400166210000061,
2250,14/08/2019,12:48:19,14/08/2019,12:48:19,0247 UKT 1203618036 0819/0008555        ,0.00,3700000,15595538257.29,19081400085550000021,
2251,14/08/2019,12:53:26,14/08/2019,12:53:26,0247 UKT 1601617176 0819/0007348        ,0.00,4000000,15599538257.29,19081400073480000026,
2252,14/08/2019,13:01:44,14/08/2019,13:01:44,0247 UKT 1603617066 0819/0013437        ,0.00,2000000,15601538257.29,19081400134370000111,
2253,14/08/2019,13:04:10,14/08/2019,13:04:10,0247 UKT 1101617116 0819/0017002        ,0.00,5300000,15606838257.29,19081400170020000055,
2254,14/08/2019,13:08:25,14/08/2019,13:08:25,0247 UKT 1604618034 0819/0011831        ,0.00,3200000,15610038257.29,19081400118310000014,
2255,14/08/2019,13:08:32,14/08/2019,13:08:32,0247 UKT 1801618019 0819/0010959        ,0.00,4000000,15614038257.29,19081400109590000024,
2256,14/08/2019,13:09:16,14/08/2019,13:09:16,0247 SPU 1939119001456 0819/0011829     ,0.00,2500000,15616538257.29,19081400118290000050,
2257,14/08/2019,13:09:25,14/08/2019,13:09:25,0247 UKT 1302617032 0819/0013799        ,0.00,6000000,15622538257.29,19081400137990000071,
2258,14/08/2019,13:09:35,14/08/2019,13:09:35,0247 UKT 1939219001793 0819/0008219     ,0.00,3000000,15625538257.29,19081400082190000109,
2259,14/08/2019,13:09:59,14/08/2019,13:09:59,0247 SPU 1939219001793 0819/0008219     ,0.00,750000,15626288257.29,19081400082190000111,
2260,14/08/2019,13:11:16,14/08/2019,13:11:16,0247 UKT 1602617180 0819/0010761        ,0.00,4700000,15630988257.29,19081400107610000068,
2261,14/08/2019,13:13:42,14/08/2019,13:13:42,0247 UKT 1801618097 0819/0008219        ,0.00,4000000,15634988257.29,19081400082190000114,
2262,14/08/2019,13:15:09,14/08/2019,13:15:09,0247 UKT 1103618014 0819/0008219        ,0.00,5300000,15640288257.29,19081400082190000116,
2263,14/08/2019,13:21:32,14/08/2019,13:21:32,0247 UKT 1209617009 0819/0016436        ,0.00,4500000,15644788257.29,19081400164360000038,
2264,14/08/2019,13:23:59,14/08/2019,13:23:59,0247 UKT 1307618031 0819/0008219        ,0.00,10000000,15654788257.29,19081400082190000120,
2265,14/08/2019,13:24:47,14/08/2019,13:24:47,0247 UKT 1107618099 0819/0012476        ,0.00,3000000,15657788257.29,19081400124760000057,
2266,14/08/2019,13:24:52,14/08/2019,13:24:52,0247 UKT                                ,0.00,5100000,15662888257.29,19081499308010014847,
2267,14/08/2019,13:26:34,14/08/2019,13:26:34,0247 UKT 1301618030 0819/0008219        ,0.00,3800000,15666688257.29,19081400082190000123,
2268,14/08/2019,13:28:31,14/08/2019,13:28:31,0247 UKT 1601618043 0819/0008219        ,0.00,5700000,15672388257.29,19081400082190000125,
2269,14/08/2019,13:30:36,14/08/2019,13:30:36,0247 UKT 1939219003527 0819/0017770     ,0.00,2700000,15675088257.29,19081400177700000135,
2270,14/08/2019,13:30:40,14/08/2019,13:30:40,0247 UKT 1602617086 0819/0008594        ,0.00,3400000,15678488257.29,19081400085940000015,
2271,14/08/2019,13:32:10,14/08/2019,13:32:10,0247 UKT 1303617043 0819/0008244        ,0.00,3950000,15682438257.29,19081400082440000065,
2272,14/08/2019,13:33:08,14/08/2019,13:33:08,0247 UKT 1203617004 0819/0008219        ,0.00,5600000,15688038257.29,19081400082190000127,
2273,14/08/2019,13:33:52,14/08/2019,13:33:52,0247 UKT 1101617064 0819/0016659        ,0.00,5300000,15693338257.29,19081400166590000093,
2274,14/08/2019,13:35:17,14/08/2019,13:35:17,0247 UKT 1208618032 0819/0012491        ,0.00,6700000,15700038257.29,19081400124910000087,
2275,14/08/2019,13:38:26,14/08/2019,13:38:26,0247 SPU 1939119000587 0819/0008219     ,0.00,750000,15700788257.29,19081400082190000130,
2276,14/08/2019,13:40:49,14/08/2019,13:40:49,0247 UKT 1104618039 0819/0007348        ,0.00,1000000,15701788257.29,19081400073480000038,
2277,14/08/2019,13:41:48,14/08/2019,13:41:48,0247 UKT 1107618079 0819/0008244        ,0.00,5100000,15706888257.29,19081400082440000067,
2278,14/08/2019,13:42:15,14/08/2019,13:42:15,0247 UKT 1209618022 0819/0017012        ,0.00,4500000,15711388257.29,19081400170120000094,
2279,14/08/2019,13:43:13,14/08/2019,13:43:13,0247 UKT 1206618005 0819/0016621        ,0.00,6700000,15718088257.29,19081400166210000078,
2280,14/08/2019,13:43:43,14/08/2019,13:43:43,0247 UKT 1102618064 0819/0010941        ,0.00,5100000,15723188257.29,19081400109410000058,
2281,14/08/2019,13:44:14,14/08/2019,13:44:14,0247 UKT 1939219009172 0819/0008219     ,0.00,4000000,15727188257.29,19081400082190000132,
2282,14/08/2019,13:45:34,14/08/2019,13:45:34,0247 UKT 1107618134 0819/0011932        ,0.00,3000000,15730188257.29,19081400119320000013,
2283,14/08/2019,13:46:28,14/08/2019,13:46:28,0247 UKT 1301617071 0819/0012491        ,0.00,3800000,15733988257.29,19081400124910000092,
2284,14/08/2019,13:46:28,14/08/2019,13:46:28,0247 UKT 1801617272 0819/0006338        ,0.00,6200000,15740188257.29,19081400063380000125,
2285,14/08/2019,13:49:26,14/08/2019,13:49:26,0247 UKT 1602617109 0819/0017744        ,0.00,4000000,15744188257.29,19081400177440000038,
2286,14/08/2019,13:50:21,14/08/2019,13:50:21,0247 UKT                                ,0.00,5200000,15749388257.29,19081499179100210281,
2287,14/08/2019,13:50:31,14/08/2019,13:50:31,0247 UKT 1101617056 0819/0009593        ,0.00,5300000,15754688257.29,19081400095930000064,
2288,14/08/2019,13:51:42,14/08/2019,13:51:42,0247 UKT 1601617179 0819/0013065        ,0.00,4700000,15759388257.29,19081400130650000024,
2289,14/08/2019,13:52:26,14/08/2019,13:52:26,0247 UKT 1801618165 0819/0010959        ,0.00,6200000,15765588257.29,19081400109590000061,
2290,14/08/2019,13:52:29,14/08/2019,13:52:29,0247 UKT 1601618049 0819/0016542        ,0.00,4700000,15770288257.29,19081400165420000063,
2291,14/08/2019,13:53:09,14/08/2019,13:53:09,0247 UKT 1302617007 0819/0008219        ,0.00,3800000,15774088257.29,19081400082190000134,
2292,14/08/2019,13:54:55,14/08/2019,13:54:55,0247 UKT 1210618054 0819/0013066        ,0.00,4600000,15778688257.29,19081400130660000037,
2293,14/08/2019,13:55:38,14/08/2019,13:55:38,0247 UKT 1102618078 0819/0011831        ,0.00,1000000,15779688257.29,19081400118310000018,
2294,14/08/2019,13:58:17,14/08/2019,13:58:17,0247 UKT 1801617260 0819/0017974        ,0.00,4000000,15783688257.29,19081400179740000116,
2295,14/08/2019,13:59:09,14/08/2019,13:59:09,0247 UKT 1939119002894 0819/0012486     ,0.00,3950000,15787638257.29,19081400124860000064,
2296,14/08/2019,14:05:20,14/08/2019,14:05:20,0247 UKT 1939119002531 0819/0016525     ,0.00,4150000,15791788257.29,19081400165250000123,
2297,14/08/2019,14:05:48,14/08/2019,14:05:48,0247 SPU 1939119002531 0819/0016525     ,0.00,750000,15792538257.29,19081400165250000125,
2298,14/08/2019,14:05:55,14/08/2019,14:05:55,0247 UKT 1107618059 0819/0008219        ,0.00,5100000,15797638257.29,19081400082190000136,
2299,14/08/2019,14:06:21,14/08/2019,14:06:21,0247 UKT 1304618043 0819/0016717        ,0.00,6200000,15803838257.29,19081400167170000033,
2300,14/08/2019,14:08:19,14/08/2019,14:08:19,0247 UKT 1601617081 0819/0008941        ,0.00,4700000,15808538257.29,19081400089410000051,
2301,14/08/2019,14:08:58,14/08/2019,14:08:58,0247 UKT 1939219013964 0819/0008594     ,0.00,6202000,15814740257.29,19081400085940000017,
2302,14/08/2019,14:12:45,14/08/2019,14:12:45,0247 UKT 1107618094 0819/0013466        ,0.00,1000000,15815740257.29,19081400134660000033,
2303,14/08/2019,14:14:03,14/08/2019,14:14:03,0247 UKT 1308617046 0819/0013447        ,0.00,6250000,15821990257.29,19081400134470000042,
2304,14/08/2019,14:14:08,14/08/2019,14:14:08,0247 UKT 1801617058 0819/0008237        ,0.00,7200000,15829190257.29,19081400082370000017,
2305,14/08/2019,14:15:28,14/08/2019,14:15:28,0247 UKT 1303618033 0819/0016717        ,0.00,3950000,15833140257.29,19081400167170000035,
2306,14/08/2019,14:16:12,14/08/2019,14:16:12,0247 UKT 1103618039 0819/0007901        ,0.00,3000000,15836140257.29,19081400079010000056,
2307,14/08/2019,14:16:39,14/08/2019,14:16:39,0247 UKT 1939119004028 0819/0016657     ,0.00,6200000,15842340257.29,19081400166570000062,
2308,14/08/2019,14:26:07,14/08/2019,14:26:07,0247 UKT 1303617047 0819/0016999        ,0.00,5200000,15847540257.29,19081400169990000051,
2309,14/08/2019,14:26:47,14/08/2019,14:26:47,0247 UKT 1201618036 0819/0007019        ,0.00,6400000,15853940257.29,19081400070190000095,
2310,14/08/2019,14:27:11,14/08/2019,14:27:11,0247 UKT 1205617082 0819/0008219        ,0.00,5900000,15859840257.29,19081400082190000143,
2311,14/08/2019,14:28:44,14/08/2019,14:28:44,0247 UKT 1304617070 0819/0017004        ,0.00,3950000,15863790257.29,19081400170040000079,
2312,14/08/2019,14:29:08,14/08/2019,14:29:08,0247 UKT 1939119003664 0819/0018000     ,0.00,4000000,15867790257.29,19081400180000000031,
2313,14/08/2019,14:29:47,14/08/2019,14:29:47,0247 SPU 1939119003664 0819/0018000     ,0.00,750000,15868540257.29,19081400180000000033,
2314,14/08/2019,14:29:51,14/08/2019,14:29:51,0247 UKT 1307617028 0819/0008219        ,0.00,4150000,15872690257.29,19081400082190000145,
2315,14/08/2019,14:31:23,14/08/2019,14:31:23,0247 UKT 1205618094 0819/0008219        ,0.00,4500000,15877190257.29,19081400082190000147,
2316,14/08/2019,14:32:34,14/08/2019,14:32:34,0247 UKT 1206617038 0819/0009574        ,0.00,1000000,15878190257.29,19081400095740000055,
2317,14/08/2019,14:32:40,14/08/2019,14:32:40,0247 UKT 1107617135 0819/0008219        ,0.00,3900000,15882090257.29,19081400082190000149,
2318,14/08/2019,14:33:43,14/08/2019,14:33:43,0247 UKT 1601617099 0819/0008219        ,0.00,4700000,15886790257.29,19081400082190000151,
2319,14/08/2019,14:37:13,14/08/2019,14:37:13,0247 UKT 1105618019 0819/0008219        ,0.00,500000,15887290257.29,19081400082190000153,
2320,14/08/2019,14:44:01,14/08/2019,14:44:01,0247 UKT 1208618051 0819/0016490        ,0.00,6700000,15893990257.29,19081400164900000055,
2321,14/08/2019,14:49:40,14/08/2019,14:49:40,0247 UKT 1206617041 0819/0008219        ,0.00,5900000,15899890257.29,19081400082190000155,
2322,14/08/2019,14:52:47,14/08/2019,14:52:47,0247 UKT 1304618039 0819/0008219        ,0.00,5200000,15905090257.29,19081400082190000157,
2323,14/08/2019,14:55:16,14/08/2019,14:55:16,0247 UKT 1601618080 0819/0008219        ,0.00,4700000,15909790257.29,19081400082190000159,
2324,14/08/2019,14:57:32,14/08/2019,14:57:32,0247 UKT 1313617019 0819/0008594        ,0.00,8800000,15918590257.29,19081400085940000025,
2325,14/08/2019,14:59:05,14/08/2019,14:59:05,0247 UKT 1939119003148 0819/0008219     ,0.00,4000000,15922590257.29,19081400082190000161,
2326,14/08/2019,14:59:28,14/08/2019,14:59:28,0247 SPU 1939119003148 0819/0008219     ,0.00,5000000,15927590257.29,19081400082190000163,
2327,14/08/2019,15:05:37,14/08/2019,15:05:37,0247 UKT 1306617028 0819/0013471        ,0.00,500000,15928090257.29,19081400134710000030,
2328,14/08/2019,15:28:03,14/08/2019,15:28:03,0247 UKT 1208617048 0819/0008219        ,0.00,6700000,15934790257.29,19081400082190000165,
2329,14/08/2019,15:29:09,14/08/2019,15:29:09,0247 UKT 1301618033 0819/0016488        ,0.00,6000000,15940790257.29,19081400164880000057,
2330,14/08/2019,15:30:01,14/08/2019,15:30:01,0247 UKT 1205617096 0819/0008219        ,0.00,5900000,15946690257.29,19081400082190000167,
2331,14/08/2019,15:38:41,14/08/2019,15:38:41,0247 UKT 1304617059 0819/0008219        ,0.00,3950000,15950640257.29,19081400082190000169,
2332,14/08/2019,17:40:45,14/08/2019,17:40:45,0247 UKT                                ,0.00,4000000,15954640257.29,19081499016240910434,
2333,14/08/2019,18:47:11,14/08/2019,18:47:11,0247 UKT                                ,0.00,3000000,15957640257.29,19081499106810371842,
2334,14/08/2019,19:28:40,14/08/2019,19:28:40,0247 UKT                                ,0.00,6700000,15964340257.29,19081499305010680433,
2335,14/08/2019,19:30:48,14/08/2019,19:30:48,0247 UKT                                ,0.00,5100000,15969440257.29,19081499479010695506,
2336,14/08/2019,20:47:03,14/08/2019,20:47:03,0247 UKT                                ,0.00,6200000,15975640257.29,19081499133160210218,
2337,15/08/2019,06:39:57,15/08/2019,06:39:57,0247 UKT                                ,0.00,5800000,15981440257.29,19081599572010342681,
2338,15/08/2019,08:04:43,15/08/2019,08:04:43,0247 UKT 1210617049 0819/0008298        ,0.00,6900000,15988340257.29,19081500082980000005,
2339,15/08/2019,08:08:53,15/08/2019,08:08:53,0247 UKT 1213618010 0819/0013467        ,0.00,5600000,15993940257.29,19081500134670000002,
2340,15/08/2019,08:11:01,15/08/2019,08:11:01,0247 UKT 1107617195 0819/0007168        ,0.00,3900000,15997840257.29,19081500071680000005,
2341,15/08/2019,08:24:52,15/08/2019,08:24:52,0247 UKT 1939219017026 0819/0008299     ,0.00,5300000,16003140257.29,19081500082990000003,
2342,15/08/2019,08:26:14,15/08/2019,08:26:14,0247 UKT 1602617077 0819/0008594        ,0.00,4700000,16007840257.29,19081500085940000002,
2343,15/08/2019,08:31:05,15/08/2019,08:31:05,0247 UKT 1301618011 0819/0010761        ,0.00,1000000,16008840257.29,19081500107610000013,
2344,15/08/2019,08:33:00,15/08/2019,08:33:00,0247 UKT 1939119000883 0819/0008594     ,0.00,3200000,16012040257.29,19081500085940000005,
2345,15/08/2019,08:33:16,15/08/2019,08:33:16,0247 UKT 1103618055 0819/0007354        ,0.00,5300000,16017340257.29,19081500073540000010,
2346,15/08/2019,08:35:48,15/08/2019,08:35:48,0247 UKT 1304618016 0819/0008219        ,0.00,4500000,16021840257.29,19081500082190000008,
2347,15/08/2019,08:36:29,15/08/2019,08:36:29,0247 UKT 1103617066 0819/0012479        ,0.00,5300000,16027140257.29,19081500124790000002,
2348,15/08/2019,08:37:10,15/08/2019,08:37:10,0247 UKT 1209618042 0819/0013447        ,0.00,6700000,16033840257.29,19081500134470000013,
2349,15/08/2019,08:46:44,15/08/2019,08:46:44,0247 UKT 1202618015 0819/0013497        ,0.00,4500000,16038340257.29,19081500134970000002,
2350,15/08/2019,08:48:17,15/08/2019,08:48:17,0247 UKT 1106617071 0819/0016412        ,0.00,5100000,16043440257.29,19081500164120000004,
2351,15/08/2019,08:48:33,15/08/2019,08:48:33,0247 UKT 1304618029 0819/0013051        ,0.00,3950000,16047390257.29,19081500130510000015,
2352,15/08/2019,08:52:37,15/08/2019,08:52:37,0247 UKT 1202618022 0819/0016441        ,0.00,3900000,16051290257.29,19081500164410000014,
2353,15/08/2019,08:53:50,15/08/2019,08:53:50,0247 UKT 1304618044 0819/0008588        ,0.00,6200000,16057490257.29,19081500085880000004,
2354,15/08/2019,08:54:52,15/08/2019,08:54:52,0247 UKT 1939219015732 0819/0008219     ,0.00,3900000,16061390257.29,19081500082190000010,
2355,15/08/2019,08:55:14,15/08/2019,08:55:14,0247 UKT 1308618008 0819/0008246        ,0.00,1000000,16062390257.29,19081500082460000016,
2356,15/08/2019,09:03:20,15/08/2019,09:03:20,0247 UKT 1603617042 0819/0008219        ,0.00,8600000,16070990257.29,19081500082190000012,
2357,15/08/2019,09:04:50,15/08/2019,09:04:50,0247 UKT 1201617008 0819/0017017        ,0.00,6000000,16076990257.29,19081500170170000006,
2358,15/08/2019,09:06:36,15/08/2019,09:06:36,0247 UKT 1939219011453 0819/0008219     ,0.00,5600000,16082590257.29,19081500082190000014,
2359,15/08/2019,09:06:55,15/08/2019,09:06:55,0247 SPU 1939219011453 0819/0008219     ,0.00,20000000,16102590257.29,19081500082190000016,
2360,15/08/2019,09:07:57,15/08/2019,09:07:57,0247 UKT 1209617033 0819/0017789        ,0.00,4500000,16107090257.29,19081500177890000013,
2361,15/08/2019,09:08:43,15/08/2019,09:08:43,0247 UKT 1801618128 0819/0017017        ,0.00,4000000,16111090257.29,19081500170170000008,
2362,15/08/2019,09:13:14,15/08/2019,09:13:14,0247 UKT 1106618043 0819/0016671        ,0.00,3000000,16114090257.29,19081500166710000016,
2363,15/08/2019,09:13:47,15/08/2019,09:13:47,0247 UKT 1313617022 0819/0016993        ,0.00,6200000,16120290257.29,19081500169930000008,
2364,15/08/2019,09:15:04,15/08/2019,09:15:04,0247 UKT 1102617066 0819/0008219        ,0.00,3000000,16123290257.29,19081500082190000019,
2365,15/08/2019,09:18:07,15/08/2019,09:18:07,0247 UKT 1939219013497 0819/0008219     ,0.00,3000000,16126290257.29,19081500082190000021,
2366,15/08/2019,09:21:10,15/08/2019,09:21:10,0247 UKT 1801618014 0819/0016700        ,0.00,4000000,16130290257.29,19081500167000000017,
2367,15/08/2019,09:22:23,15/08/2019,09:22:23,0247 UKT                                ,0.00,2700000,16132990257.29,19081599516010423332,
2368,15/08/2019,09:23:33,15/08/2019,09:23:33,0247 UKT 1939219007048 0819/0009593     ,0.00,5900000,16138890257.29,19081500095930000010,
2369,15/08/2019,09:24:02,15/08/2019,09:24:02,0247 UKT 1939219017247 0819/0008219     ,0.00,6700000,16145590257.29,19081500082190000023,
2370,15/08/2019,09:27:36,15/08/2019,09:27:36,0247 UKT 1308618014 0819/0008219        ,0.00,4150000,16149740257.29,19081500082190000025,
2371,15/08/2019,09:31:23,15/08/2019,09:31:23,0247 UKT 1939219007990 0819/0016657     ,0.00,5300000,16155040257.29,19081500166570000029,
2372,15/08/2019,09:32:46,15/08/2019,09:32:46,0247 UKT 1107618061 0819/0007754        ,0.00,6400000,16161440257.29,19081500077540000029,
2373,15/08/2019,09:32:58,15/08/2019,09:32:58,0247 UKT 1213617033 0819/0008219        ,0.00,5600000,16167040257.29,19081500082190000027,
2374,15/08/2019,09:34:06,15/08/2019,09:34:06,0247 UKT 1603617113 0819/0009659        ,0.00,3200000,16170240257.29,19081500096590000008,
2375,15/08/2019,09:34:59,15/08/2019,09:34:59,0247 SPU 1939219014532 0819/0008219     ,0.00,1000000,16171240257.29,19081500082190000029,
2376,15/08/2019,09:36:07,15/08/2019,09:36:07,0247 UKT 1213617039 0819/0008219        ,0.00,3700000,16174940257.29,19081500082190000031,
2377,15/08/2019,09:38:25,15/08/2019,09:38:25,0247 UKT 1201617068 0819/0017996        ,0.00,4000000,16178940257.29,19081500179960000033,
2378,15/08/2019,09:39:23,15/08/2019,09:39:23,0247 UKT 1308618041 0819/0011838        ,0.00,8000000,16186940257.29,19081500118380000003,
2379,15/08/2019,09:42:03,15/08/2019,09:42:03,0247 UKT 1308618065 0819/0008219        ,0.00,4150000,16191090257.29,19081500082190000035,
2380,15/08/2019,09:43:14,15/08/2019,09:43:14,0247 UKT 1801617064 0819/0007357        ,0.00,4000000,16195090257.29,19081500073570000025,
2381,15/08/2019,09:54:09,15/08/2019,09:54:09,0247 UKT 1939219015931 0819/0008219     ,0.00,5900000,16200990257.29,19081500082190000039,
2382,15/08/2019,09:54:25,15/08/2019,09:54:25,0247 SPU 1939219015931 0819/0008219     ,0.00,750000,16201740257.29,19081500082190000041,
2383,15/08/2019,09:55:47,15/08/2019,09:55:47,0247 UKT 1211618032 0819/0008219        ,0.00,1000000,16202740257.29,19081500082190000043,
2384,15/08/2019,09:56:37,15/08/2019,09:56:37,0247 UKT 1939219006572 0819/0012491     ,0.00,3200000,16205940257.29,19081500124910000016,
2385,15/08/2019,09:59:09,15/08/2019,09:59:09,0247 UKT 1207618008 0819/0008246        ,0.00,1000000,16206940257.29,19081500082460000032,
2386,15/08/2019,10:01:48,15/08/2019,10:01:48,0247 UKT 1801618139 0819/0013072        ,0.00,6200000,16213140257.29,19081500130720000036,
2387,15/08/2019,10:02:55,15/08/2019,10:02:55,0247 UKT 1104617046 0819/0013080        ,0.00,1000000,16214140257.29,19081500130800000010,
2388,15/08/2019,10:07:10,15/08/2019,10:07:10,0247 UKT 1939219004033 0819/0008219     ,0.00,4000000,16218140257.29,19081500082190000045,
2389,15/08/2019,10:08:35,15/08/2019,10:08:35,0247 UKT 1939219002658 0819/0008219     ,0.00,1000000,16219140257.29,19081500082190000047,
2390,15/08/2019,10:09:53,15/08/2019,10:09:53,0247 SPU 1939219006885 0819/0012480     ,0.00,800000,16219940257.29,19081500124800000019,
2391,15/08/2019,10:10:51,15/08/2019,10:10:51,0247 UKT 1107617105 0819/0016491        ,0.00,6400000,16226340257.29,19081500164910000026,
2392,15/08/2019,10:11:04,15/08/2019,10:11:04,0247 UKT 1939219006885 0819/0012480     ,0.00,8200000,16234540257.29,19081500124800000021,
2393,15/08/2019,10:11:37,15/08/2019,10:11:37,0247 UKT 1939219002696 0819/0008219     ,0.00,5700000,16240240257.29,19081500082190000049,
2394,15/08/2019,10:12:00,15/08/2019,10:12:00,0247 SPU 1939219002696 0819/0008219     ,0.00,750000,16240990257.29,19081500082190000051,
2395,15/08/2019,10:12:36,15/08/2019,10:12:36,0247 UKT 1601617150 0819/0012249        ,0.00,2700000,16243690257.29,19081500122490000024,
2396,15/08/2019,10:12:42,15/08/2019,10:12:42,0247 UKT 1314617030 0819/0013494        ,0.00,4000000,16247690257.29,19081500134940000005,
2397,15/08/2019,10:13:49,15/08/2019,10:13:49,0247 UKT 1939219010346 0819/0008219     ,0.00,4700000,16252390257.29,19081500082190000053,
2398,15/08/2019,10:14:06,15/08/2019,10:14:06,0247 UKT 1604618031 0819/0013678        ,0.00,1000000,16253390257.29,19081500136780000029,
2399,15/08/2019,10:14:09,15/08/2019,10:14:09,0247 SPU 1939219010346 0819/0008219     ,0.00,800000,16254190257.29,19081500082190000055,
2400,15/08/2019,10:15:29,15/08/2019,10:15:29,0247 UKT 1107617110 0819/0017995        ,0.00,3000000,16257190257.29,19081500179950000122,
2401,15/08/2019,10:16:02,15/08/2019,10:16:02,0247 UKT 1939219014959 0819/0008219     ,0.00,3200000,16260390257.29,19081500082190000057,
2402,15/08/2019,10:16:34,15/08/2019,10:16:34,0247 UKT 1210618010 0819/0008225        ,0.00,4600000,16264990257.29,19081500082250000018,
2403,15/08/2019,10:16:43,15/08/2019,10:16:43,0247 UKT                                ,0.00,5600000,16270590257.29,19081599113810840781,
2404,15/08/2019,10:17:39,15/08/2019,10:17:39,0247 UKT 1939319000835 0819/0008219     ,0.00,1000000,16271590257.29,19081500082190000059,
2405,15/08/2019,10:17:55,15/08/2019,10:17:55,0247 SPU 1939319000835 0819/0008219     ,0.00,750000,16272340257.29,19081500082190000061,
2406,15/08/2019,10:19:57,15/08/2019,10:19:57,0247 UKT 1601617054 0819/0007357        ,0.00,5700000,16278040257.29,19081500073570000031,
2407,15/08/2019,10:20:36,15/08/2019,10:20:36,0247 UKT 1107617197 0819/0018006        ,0.00,3000000,16281040257.29,19081500180060000021,
2408,15/08/2019,10:20:39,15/08/2019,10:20:39,0247 UKT 1308618040 0819/0008219        ,0.00,10000000,16291040257.29,19081500082190000063,
2409,15/08/2019,10:21:40,15/08/2019,10:21:40,0247 UKT 1939219003963 0819/0008219     ,0.00,1000000,16292040257.29,19081500082190000065,
2410,15/08/2019,10:22:10,15/08/2019,10:22:10,0247 UKT 1203617013 0819/0007348        ,0.00,5000000,16297040257.29,19081500073480000051,
2411,15/08/2019,10:26:36,15/08/2019,10:26:36,0247 UKT 1304618074 0819/0008219        ,0.00,6200000,16303240257.29,19081500082190000069,
2412,15/08/2019,10:27:42,15/08/2019,10:27:42,0247 UKT 1302618025 0819/0016541        ,0.00,3800000,16307040257.29,19081500165410000030,
2413,15/08/2019,10:30:50,15/08/2019,10:30:50,0247 UKT 1302618012 0819/0016541        ,0.00,6000000,16313040257.29,19081500165410000032,
2414,15/08/2019,10:30:51,15/08/2019,10:30:51,0247 UKT 1302617023 0819/0016689        ,0.00,3800000,16316840257.29,19081500166890000051,
2415,15/08/2019,10:33:24,15/08/2019,10:33:24,0247 UKT 1939219005975 0819/0016717     ,0.00,3200000,16320040257.29,19081500167170000012,
2416,15/08/2019,10:35:45,15/08/2019,10:35:45,0247 UKT 1603617019 0819/0016629        ,0.00,5400000,16325440257.29,19081500166290000041,
2417,15/08/2019,10:36:35,15/08/2019,10:36:35,0247 UKT 1103617068 0819/0008219        ,0.00,6000000,16331440257.29,19081500082190000071,
2418,15/08/2019,10:38:42,15/08/2019,10:38:42,0247 UKT 1103617091 0819/0012249        ,0.00,3000000,16334440257.29,19081500122490000027,
2419,15/08/2019,10:39:18,15/08/2019,10:39:18,0247 UKT 1301618027 0819/0018006        ,0.00,3800000,16338240257.29,19081500180060000025,
2420,15/08/2019,10:43:58,15/08/2019,10:43:58,0247 UKT 1601617089 0819/0013069        ,0.00,4700000,16342940257.29,19081500130690000015,
2421,15/08/2019,10:44:26,15/08/2019,10:44:26,0247 UKT 1107617248 0819/0017017        ,0.00,5100000,16348040257.29,19081500170170000023,
2422,15/08/2019,10:44:59,15/08/2019,10:44:59,0247 UKT 1106618009 0819/0007337        ,0.00,4500000,16352540257.29,19081500073370000017,
2423,15/08/2019,10:46:26,15/08/2019,10:46:26,0247 UKT 1107617038 0819/0017017        ,0.00,4500000,16357040257.29,19081500170170000025,
2424,15/08/2019,10:46:53,15/08/2019,10:46:53,0247 UKT 1939219009614 0819/0016631     ,0.00,4700000,16361740257.29,19081500166310000020,
2425,15/08/2019,10:54:38,15/08/2019,10:54:38,0247 UKT 1107617261 0819/0010496        ,0.00,3000000,16364740257.29,19081500104960000062,
2426,15/08/2019,10:55:02,15/08/2019,10:55:02,0247 UKT 1102617087 0819/0007901        ,0.00,4500000,16369240257.29,19081500079010000039,
2427,15/08/2019,10:58:01,15/08/2019,10:58:01,0247 UKT 1307617016 0819/0011541        ,0.00,4150000,16373390257.29,19081500115410000040,
2428,15/08/2019,10:58:54,15/08/2019,10:58:54,0247 UKT 1103618069 0819/0008219        ,0.00,3000000,16376390257.29,19081500082190000075,
2429,15/08/2019,10:59:05,15/08/2019,10:59:05,0247 UKT 1603617120 0819/0008551        ,0.00,4300000,16380690257.29,19081500085510000012,
2430,15/08/2019,11:06:27,15/08/2019,11:06:27,0247 UKT 1202617036 0819/0008219        ,0.00,5200000,16385890257.29,19081500082190000077,
2431,15/08/2019,11:07:48,15/08/2019,11:07:48,0247 UKT 1801617094 0819/0006635        ,0.00,8200000,16394090257.29,19081500066350000030,
2432,15/08/2019,11:08:10,15/08/2019,11:08:10,0247 UKT 1939119004152 0819/0008219     ,0.00,6250000,16400340257.29,19081500082190000079,
2433,15/08/2019,11:08:13,15/08/2019,11:08:13,0247 UKT 1801618119 0819/0010961        ,0.00,8200000,16408540257.29,19081500109610000053,
2434,15/08/2019,11:08:55,15/08/2019,11:08:55,0247 UKT 1939219008069 0819/0007900     ,0.00,7200000,16415740257.29,19081500079000000015,
2435,15/08/2019,11:10:21,15/08/2019,11:10:21,0247 UKT 1304618076 0819/0008219        ,0.00,3950000,16419690257.29,19081500082190000081,
2436,15/08/2019,11:10:21,15/08/2019,11:10:21,0247 UKT 1106618061 0819/0016438        ,0.00,5100000,16424790257.29,19081500164380000092,
2437,15/08/2019,11:10:30,15/08/2019,11:10:30,0247 UKT 1313617027 0819/0018000        ,0.00,8000000,16432790257.29,19081500180000000013,
2438,15/08/2019,11:13:30,15/08/2019,11:13:30,0247 UKT 1314617034 0819/0009574        ,0.00,5200000,16437990257.29,19081500095740000089,
2439,15/08/2019,11:16:06,15/08/2019,11:16:06,0247 UKT 1107618023 0819/0008937        ,0.00,4500000,16442490257.29,19081500089370000018,
2440,15/08/2019,11:16:20,15/08/2019,11:16:20,0247 UKT 1105617058 0819/0012882        ,0.00,3900000,16446390257.29,19081500128820000038,
2441,15/08/2019,11:16:34,15/08/2019,11:16:34,0247 SPU 1939119001136 0819/0018024     ,0.00,750000,16447140257.29,19081500180240000040,
2442,15/08/2019,11:17:24,15/08/2019,11:17:24,0247 UKT 1939119001136 0819/0018024     ,0.00,7500000,16454640257.29,19081500180240000044,
2443,15/08/2019,11:17:58,15/08/2019,11:17:58,0247 UKT 1303618045 0819/0008588        ,0.00,3950000,16458590257.29,19081500085880000050,
2444,15/08/2019,11:18:13,15/08/2019,11:18:13,0247 UKT 1101617101 0819/0018027        ,0.00,3000000,16461590257.29,19081500180270000016,
2445,15/08/2019,11:21:35,15/08/2019,11:21:35,0247 UKT 1205617079 0819/0009574        ,0.00,3900000,16465490257.29,19081500095740000091,
2446,15/08/2019,11:21:43,15/08/2019,11:21:43,0247 UKT 1305617014 0819/0018000        ,0.00,6200000,16471690257.29,19081500180000000015,
2447,15/08/2019,11:23:29,15/08/2019,11:23:29,0247 UKT 1101618067 0819/0016629        ,0.00,1000000,16472690257.29,19081500166290000043,
2448,15/08/2019,11:23:35,15/08/2019,11:23:35,0247 UKT                                ,0.00,5100000,16477790257.29,19081599617010358030,
2449,15/08/2019,11:25:03,15/08/2019,11:25:03,0247 UKT 1210618042 0819/0016629        ,0.00,1000000,16478790257.29,19081500166290000045,
2450,15/08/2019,11:26:55,15/08/2019,11:26:55,0247 UKT 1104617067 0819/0007019        ,0.00,4000000,16482790257.29,19081500070190000035,
2451,15/08/2019,11:27:27,15/08/2019,11:27:27,0247 UKT 1308618057 0819/0016412        ,0.00,6250000,16489040257.29,19081500164120000026,
2452,15/08/2019,11:27:35,15/08/2019,11:27:35,0247 UKT 1602617208 0819/0018000        ,0.00,2700000,16491740257.29,19081500180000000017,
2453,15/08/2019,11:31:29,15/08/2019,11:31:29,0247 UKT 1303617033 0819/0017002        ,0.00,3950000,16495690257.29,19081500170020000040,
2454,15/08/2019,11:41:21,15/08/2019,11:41:21,0247 UKT 1939219012593 0819/0008219     ,0.00,6700000,16502390257.29,19081500082190000084,
2455,15/08/2019,11:41:52,15/08/2019,11:41:52,0247 UKT 1604618025 0819/0010512        ,0.00,500000,16502890257.29,19081500105120000022,
2456,15/08/2019,11:42:15,15/08/2019,11:42:15,0247 UKT 1801618122 0819/0011829        ,0.00,8200000,16511090257.29,19081500118290000006,
2457,15/08/2019,11:42:17,15/08/2019,11:42:17,0247 UKT 1939219010228 0819/0008219     ,0.00,1000000,16512090257.29,19081500082190000086,
2458,15/08/2019,11:44:12,15/08/2019,11:44:12,0247 SPU 1939119003555 0819/0008219     ,0.00,750000,16512840257.29,19081500082190000088,
2459,15/08/2019,11:46:04,15/08/2019,11:46:04,0247 UKT 1304618055 0819/0008219        ,0.00,6200000,16519040257.29,19081500082190000090,
2460,15/08/2019,11:46:49,15/08/2019,11:46:49,0247 SPU 1939219017084 0819/0016530     ,0.00,800000,16519840257.29,19081500165300000046,
2461,15/08/2019,11:46:54,15/08/2019,11:46:54,0247 UKT 1205618056 0819/0008219        ,0.00,3900000,16523740257.29,19081500082190000092,
2462,15/08/2019,11:47:06,15/08/2019,11:47:06,0247 UKT 1939219017084 0819/0016530     ,0.00,3000000,16526740257.29,19081500165300000048,
2463,15/08/2019,11:47:57,15/08/2019,11:47:57,0247 UKT 1601617108 0819/0013436        ,0.00,5700000,16532440257.29,19081500134360000052,
2464,15/08/2019,11:48:23,15/08/2019,11:48:23,0247 UKT 1939219014977 0819/0008219     ,0.00,4000000,16536440257.29,19081500082190000095,
2465,15/08/2019,11:49:29,15/08/2019,11:49:29,0247 UKT 1304618020 0819/0018353        ,0.00,3950000,16540390257.29,19081500183530000042,
2466,15/08/2019,11:50:42,15/08/2019,11:50:42,0247 UKT 1207618032 0819/0013498        ,0.00,7400000,16547790257.29,19081500134980000098,
2467,15/08/2019,11:54:38,15/08/2019,11:54:38,0247 UKT 1102617091 0819/0010758        ,0.00,5100000,16552890257.29,19081500107580000011,
2468,15/08/2019,11:57:53,15/08/2019,11:57:53,0247 UKT 1304618067 0819/0016489        ,0.00,6200000,16559090257.29,19081500164890000026,
2469,15/08/2019,12:00:00,15/08/2019,12:00:00,0247 UKT 1314618005 0819/0008219        ,0.00,6400000,16565490257.29,19081500082190000098,
2470,15/08/2019,12:03:48,15/08/2019,12:03:48,0247 UKT                                ,0.00,5500000,16570990257.29,19081599113810656323,
2471,15/08/2019,12:07:37,15/08/2019,12:07:37,0247 UKT 1939219008078 0819/0012233     ,0.00,5600000,16576590257.29,19081500122330000023,
2472,15/08/2019,12:12:42,15/08/2019,12:12:42,0247 UKT 1202618021 0819/0008550        ,0.00,3900000,16580490257.29,19081500085500000126,
2473,15/08/2019,12:12:45,15/08/2019,12:12:45,0247 UKT 1939219005024 0819/0018004     ,0.00,6700000,16587190257.29,19081500180040000017,
2474,15/08/2019,12:13:08,15/08/2019,12:13:08,0247 SPU 1939219005024 0819/0018004     ,0.00,1000000,16588190257.29,19081500180040000019,
2475,15/08/2019,12:13:24,15/08/2019,12:13:24,0247 UKT 1201617065 0819/0007901        ,0.00,1000000,16589190257.29,19081500079010000053,
2476,15/08/2019,12:27:03,15/08/2019,12:27:03,0247 UKT 1107618138 0819/0012479        ,0.00,5100000,16594290257.29,19081500124790000006,
2477,15/08/2019,12:29:26,15/08/2019,12:29:26,0247 UKT 1939219014445 0819/0016630     ,0.00,4700000,16598990257.29,19081500166300000014,
2478,15/08/2019,12:30:08,15/08/2019,12:30:08,0247 SPU 1939219014445 0819/0016630     ,0.00,800000,16599790257.29,19081500166300000016,
2479,15/08/2019,12:39:52,15/08/2019,12:39:52,0247 UKT 1204617002 0819/0016721        ,0.00,5900000,16605690257.29,19081500167210000028,
2480,15/08/2019,12:42:26,15/08/2019,12:42:26,0247 UKT 1101617087 0819/0009752        ,0.00,3000000,16608690257.29,19081500097520000028,
2481,15/08/2019,12:45:21,15/08/2019,12:45:21,0247 UKT 1210617054 0819/0007895        ,0.00,4600000,16613290257.29,19081500078950000019,
2482,15/08/2019,12:47:32,15/08/2019,12:47:32,0247 UKT 1102617096 0819/0017995        ,0.00,1000000,16614290257.29,19081500179950000125,
2483,15/08/2019,12:51:45,15/08/2019,12:51:45,0247 UKT 1939119001882 0819/0008264     ,0.00,3800000,16618090257.29,19081500082640000030,
2484,15/08/2019,12:52:05,15/08/2019,12:52:05,0247 UKT 1303617063 0819/0009752        ,0.00,3950000,16622040257.29,19081500097520000030,
2485,15/08/2019,12:53:48,15/08/2019,12:53:48,0247 SPU 1939119001882 0819/0008264     ,0.00,1000000,16623040257.29,19081500082640000032,
2486,15/08/2019,12:54:33,15/08/2019,12:54:33,0247 UKT 1205618019 0819/0016438        ,0.00,3900000,16626940257.29,19081500164380000125,
2487,15/08/2019,12:54:38,15/08/2019,12:54:38,0247 UKT 1301617049 0819/0012491        ,0.00,6000000,16632940257.29,19081500124910000068,
2488,15/08/2019,12:57:30,15/08/2019,12:57:30,0247 UKT 1105618059 0819/0008225        ,0.00,5100000,16638040257.29,19081500082250000031,
2489,15/08/2019,12:59:40,15/08/2019,12:59:40,0247 UKT 1801617013 0819/0007754        ,0.00,6200000,16644240257.29,19081500077540000077,
2490,15/08/2019,13:01:58,15/08/2019,13:01:58,0247 UKT 1104617013 0819/0013447        ,0.00,3000000,16647240257.29,19081500134470000084,
2491,15/08/2019,13:02:09,15/08/2019,13:02:09,0247 UKT 1801618123 0819/0006664        ,0.00,4000000,16651240257.29,19081500066640000009,
2492,15/08/2019,13:02:35,15/08/2019,13:02:35,0247 UKT 1601617129 0819/0007346        ,0.00,5400000,16656640257.29,19081500073460000073,
2493,15/08/2019,13:04:17,15/08/2019,13:04:17,0247 UKT 1209617022 0819/0007348        ,0.00,5900000,16662540257.29,19081500073480000072,
2494,15/08/2019,13:07:02,15/08/2019,13:07:02,0247 UKT 1105618062 0819/0010960        ,0.00,500000,16663040257.29,19081500109600000019,
2495,15/08/2019,13:07:09,15/08/2019,13:07:09,0247 UKT 1205618072 0819/0008219        ,0.00,5900000,16668940257.29,19081500082190000102,
2496,15/08/2019,13:15:39,15/08/2019,13:15:39,0247 UKT 1939219003489 0819/0008219     ,0.00,7400000,16676340257.29,19081500082190000108,
2497,15/08/2019,13:17:07,15/08/2019,13:17:07,0247 SPU 1939219003489 0819/0008219     ,0.00,4000000,16680340257.29,19081500082190000111,
2498,15/08/2019,13:17:59,15/08/2019,13:17:59,0247 UKT 1308618036 0819/0017982        ,0.00,8000000,16688340257.29,19081500179820000044,
2499,15/08/2019,13:20:13,15/08/2019,13:20:13,0247 SPU 1939219003554 0819/0008219     ,0.00,750000,16689090257.29,19081500082190000113,
2500,15/08/2019,13:20:46,15/08/2019,13:20:46,0247 UKT 1939119003361 0819/0016491     ,0.00,3800000,16692890257.29,19081500164910000052,
2501,15/08/2019,13:21:19,15/08/2019,13:21:19,0247 SPU 1939119003361 0819/0016491     ,0.00,750000,16693640257.29,19081500164910000054,
2502,15/08/2019,13:21:37,15/08/2019,13:21:37,0247 UKT 1307617003 0819/0009761        ,0.00,4150000,16697790257.29,19081500097610000164,
2503,15/08/2019,13:21:53,15/08/2019,13:21:53,0247 UKT 1313617023 0819/0008219        ,0.00,1000000,16698790257.29,19081500082190000115,
2504,15/08/2019,13:22:40,15/08/2019,13:22:40,0247 UKT 1102618011 0819/0018233        ,0.00,5100000,16703890257.29,19081500182330000068,
2505,15/08/2019,13:24:21,15/08/2019,13:24:21,0247 UKT 1202618023 0819/0008219        ,0.00,3900000,16707790257.29,19081500082190000117,
2506,15/08/2019,13:25:53,15/08/2019,13:25:53,0247 UKT 1202617025 0819/0008219        ,0.00,1000000,16708790257.29,19081500082190000119,
2507,15/08/2019,13:28:10,15/08/2019,13:28:10,0247 UKT 1308617036 0819/0017997        ,0.00,6250000,16715040257.29,19081500179970000038,
2508,15/08/2019,13:31:50,15/08/2019,13:31:50,0247 UKT 1205617086 0819/0018015        ,0.00,3900000,16718940257.29,19081500180150000050,
2509,15/08/2019,13:33:14,15/08/2019,13:33:14,0247 UKT 1602618048 0819/0012476        ,0.00,1000000,16719940257.29,19081500124760000064,
2510,15/08/2019,13:34:39,15/08/2019,13:34:39,0247 UKT 1209617073 0819/0012476        ,0.00,7400000,16727340257.29,19081500124760000066,
2511,15/08/2019,13:36:21,15/08/2019,13:36:21,0247 UKT 1307617033 0819/0010956        ,0.00,4650000,16731990257.29,19081500109560000127,
2512,15/08/2019,13:36:40,15/08/2019,13:36:40,0247 UKT 1939219015324 0819/0016716     ,0.00,3900000,16735890257.29,19081500167160000023,
2513,15/08/2019,13:38:00,15/08/2019,13:38:00,0247 UKT 1304617046 0819/0017983        ,0.00,5200000,16741090257.29,19081500179830000037,
2514,15/08/2019,13:40:26,15/08/2019,13:40:26,0247 UKT 1103617017 0819/0013446        ,0.00,5300000,16746390257.29,19081500134460000033,
2515,15/08/2019,13:42:54,15/08/2019,13:42:54,0247 UKT 1105617011 0819/0007900        ,0.00,3000000,16749390257.29,19081500079000000039,
2516,15/08/2019,13:44:29,15/08/2019,13:44:29,0247 UKT 1939219014023 0819/0008935     ,0.00,4700000,16754090257.29,19081500089350000053,
2517,15/08/2019,13:45:47,15/08/2019,13:45:47,0247 UKT 1107618088 0819/0016525        ,0.00,1000000,16755090257.29,19081500165250000027,
2518,15/08/2019,13:45:57,15/08/2019,13:45:57,0247 UKT 1102617098 0819/0016990        ,0.00,5100000,16760190257.29,19081500169900000057,
2519,15/08/2019,13:46:34,15/08/2019,13:46:34,0247 UKT 1206617055 0819/0016715        ,0.00,500000,16760690257.29,19081500167150000044,
2520,15/08/2019,13:47:46,15/08/2019,13:47:46,0247 UKT 1104617056 0819/0012491        ,0.00,5300000,16765990257.29,19081500124910000072,
2521,15/08/2019,13:47:48,15/08/2019,13:47:48,0247 UKT 1939219006969 0819/0008219     ,0.00,5900000,16771890257.29,19081500082190000121,
2522,15/08/2019,13:48:01,15/08/2019,13:48:01,0247 SPU 1939219006969 0819/0008219     ,0.00,750000,16772640257.29,19081500082190000123,
2523,15/08/2019,13:48:59,15/08/2019,13:48:59,0247 UKT 1939219001788 0819/0008298     ,0.00,5100000,16777740257.29,19081500082980000012,
2524,15/08/2019,13:51:38,15/08/2019,13:51:38,0247 UKT 1939219009819 0819/0012493     ,0.00,6700000,16784440257.29,19081500124930000073,
2525,15/08/2019,13:52:23,15/08/2019,13:52:23,0247 UKT 1201617010 0819/0016541        ,0.00,6000000,16790440257.29,19081500165410000144,
2526,15/08/2019,14:05:51,15/08/2019,14:05:51,0247 UKT 1206617027 0819/0013051        ,0.00,6700000,16797140257.29,19081500130510000051,
2527,15/08/2019,14:07:19,15/08/2019,14:07:19,0247 UKT 1101617089 0819/0009757        ,0.00,4000000,16801140257.29,19081500097570000040,
2528,15/08/2019,14:08:24,15/08/2019,14:08:24,0247 UKT 1939219014355 0819/0008219     ,0.00,3200000,16804340257.29,19081500082190000152,
2529,15/08/2019,14:09:04,15/08/2019,14:09:04,0247 UKT 1104618009 0819/0012937        ,0.00,5300000,16809640257.29,19081500129370000006,
2530,15/08/2019,14:12:50,15/08/2019,14:12:50,0247 UKT 1107618095 0819/0016538        ,0.00,3000000,16812640257.29,19081500165380000093,
2531,15/08/2019,14:14:18,15/08/2019,14:14:18,0247 UKT 1106617008 0819/0017790        ,0.00,6400000,16819040257.29,19081500177900000115,
2532,15/08/2019,14:14:31,15/08/2019,14:14:31,0247 UKT 1102618052 0819/0007463        ,0.00,5100000,16824140257.29,19081500074630000043,
2533,15/08/2019,14:19:14,15/08/2019,14:19:14,0247 UKT 1105618072 0819/0008219        ,0.00,5100000,16829240257.29,19081500082190000154,
2534,15/08/2019,14:19:27,15/08/2019,14:19:27,0247 UKT 1102618072 0819/0017968        ,0.00,5100000,16834340257.29,19081500179680000035,
2535,15/08/2019,14:26:48,15/08/2019,14:26:48,0247 UKT 1107618034 0819/0008219        ,0.00,1000000,16835340257.29,19081500082190000158,
2536,15/08/2019,14:28:33,15/08/2019,14:28:33,0247 UKT 1939219005601 0819/0010941     ,0.00,4600000,16839940257.29,19081500109410000037,
2537,15/08/2019,14:30:25,15/08/2019,14:30:25,0247 UKT 1205617102 0819/0007168        ,0.00,5900000,16845840257.29,19081500071680000238,
2538,15/08/2019,14:34:31,15/08/2019,14:34:31,0247 UKT 1302618010 0819/0008219        ,0.00,3800000,16849640257.29,19081500082190000160,
2539,15/08/2019,14:37:33,15/08/2019,14:37:33,0247 UKT 1939219015630 0819/0008219     ,0.00,3900000,16853540257.29,19081500082190000162,
2540,15/08/2019,14:37:55,15/08/2019,14:37:55,0247 SPU 1939219015630 0819/0008219     ,0.00,800000,16854340257.29,19081500082190000164,
2541,15/08/2019,14:41:30,15/08/2019,14:41:30,0247 UKT 1104617108 0819/0012936        ,0.00,4700000,16859040257.29,19081500129360000038,
2542,15/08/2019,14:41:32,15/08/2019,14:41:32,0247 UKT 1939219002321 0819/0012234     ,0.00,4500000,16863540257.29,19081500122340000072,
2543,15/08/2019,14:42:12,15/08/2019,14:42:12,0247 UKT 1107617032 0819/0008225        ,0.00,3000000,16866540257.29,19081500082250000042,
2544,15/08/2019,14:47:56,15/08/2019,14:47:56,0247 UKT 1207617008 0819/0008219        ,0.00,4500000,16871040257.29,19081500082190000166,
2545,15/08/2019,14:57:49,15/08/2019,14:57:49,0247 UKT 1939219003162 0819/0007901     ,0.00,4500000,16875540257.29,19081500079010000077,
2546,15/08/2019,15:00:04,15/08/2019,15:00:04,0247 UKT 1801618161 0819/0007900        ,0.00,8200000,16883740257.29,19081500079000000044,
2547,15/08/2019,15:00:26,15/08/2019,15:00:26,0247 UKT 1801617262 0819/0016657        ,0.00,8200000,16891940257.29,19081500166570000058,
2548,15/08/2019,15:00:53,15/08/2019,15:00:53,0247 UKT 1302618065 0819/0008219        ,0.00,3800000,16895740257.29,19081500082190000168,
2549,15/08/2019,15:03:31,15/08/2019,15:03:31,0247 UKT                                ,0.00,6200000,16901940257.29,19081599113810942226,
2550,15/08/2019,15:04:09,15/08/2019,15:04:09,0247 UKT 1313618019 0819/0008219        ,0.00,4000000,16905940257.29,19081500082190000170,
2551,15/08/2019,15:05:08,15/08/2019,15:05:08,0247 UKT 1104618012 0819/0013446        ,0.00,5300000,16911240257.29,19081500134460000041,
2552,15/08/2019,15:06:25,15/08/2019,15:06:25,0247 UKT 1102617116 0819/0008219        ,0.00,5100000,16916340257.29,19081500082190000172,
2553,15/08/2019,15:09:37,15/08/2019,15:09:37,0247 UKT 1102618028 0819/0010977        ,0.00,3900000,16920240257.29,19081500109770000010,
2554,15/08/2019,15:12:31,15/08/2019,15:12:31,0247 UKT 1801617193 0819/0008214        ,0.00,10300000,16930540257.29,19081500082140000035,
2555,15/08/2019,15:14:15,15/08/2019,15:14:15,0247 UKT 1602618041 0819/0013678        ,0.00,4700000,16935240257.29,19081500136780000098,
2556,15/08/2019,15:14:53,15/08/2019,15:14:53,0247 UKT 1208617014 0819/0008219        ,0.00,7400000,16942640257.29,19081500082190000177,
2557,15/08/2019,15:17:52,15/08/2019,15:17:52,0247 UKT 1301617043 0819/0007901        ,0.00,5000000,16947640257.29,19081500079010000079,
2558,15/08/2019,15:19:28,15/08/2019,15:19:28,0247 UKT 1203617062 0819/0010411        ,0.00,500000,16948140257.29,19081500104110000090,
2559,15/08/2019,15:24:25,15/08/2019,15:24:25,0247 UKT 1308618060 0819/0008219        ,0.00,4650000,16952790257.29,19081500082190000179,
2560,15/08/2019,16:18:10,15/08/2019,16:18:10,0247 UKT                                ,0.00,500000,16953290257.29,19081599120010473652,
2561,15/08/2019,16:58:25,15/08/2019,16:58:25,0247 UKT                                ,0.00,4150000,16957440257.29,19081599135010774302,
2562,16/08/2019,08:03:19,16/08/2019,08:03:19,0247 UKT 1307617018 0819/0008219        ,0.00,4150000,16961590257.29,19081600082190000002,
2563,16/08/2019,08:23:04,16/08/2019,08:23:04,0247 UKT 1106617075 0819/0017994        ,0.00,4500000,16966090257.29,19081600179940000002,
2564,16/08/2019,08:27:53,16/08/2019,08:27:53,0247 UKT 1313617038 0819/0016544        ,0.00,5200000,16971290257.29,19081600165440000002,
2565,16/08/2019,08:30:56,16/08/2019,08:30:56,0247 UKT 1203617070 0819/0008219        ,0.00,1000000,16972290257.29,19081600082190000005,
2566,16/08/2019,08:31:43,16/08/2019,08:31:43,0247 UKT 1207618054 0819/0007019        ,0.00,6700000,16978990257.29,19081600070190000004,
2567,16/08/2019,08:31:58,16/08/2019,08:31:58,0247 UKT 1210617037 0819/0016659        ,0.00,4600000,16983590257.29,19081600166590000004,
2568,16/08/2019,08:46:37,16/08/2019,08:46:37,0247 UKT 1939219007812 0819/0018015     ,0.00,5300000,16988890257.29,19081600180150000020,
2569,16/08/2019,08:49:12,16/08/2019,08:49:12,0247 UKT 1106617057 0819/0009746        ,0.00,5800000,16994690257.29,19081600097460000003,
2570,16/08/2019,08:49:22,16/08/2019,08:49:22,0247 UKT 1939219013450 0819/0008957     ,0.00,3900000,16998590257.29,19081600089570000004,
2571,16/08/2019,08:53:39,16/08/2019,08:53:39,0247 UKT 1801617018 0819/0013055        ,0.00,4000000,17002590257.29,19081600130550000018,
2572,16/08/2019,08:56:05,16/08/2019,08:56:05,0247 UKT 1102617108 0819/0017989        ,0.00,5100000,17007690257.29,19081600179890000004,
2573,16/08/2019,08:56:06,16/08/2019,08:56:06,0247 UKT 1207618010 0819/0008219        ,0.00,1000000,17008690257.29,19081600082190000007,
2574,16/08/2019,08:56:33,16/08/2019,08:56:33,0247 UKT 1209617004 0819/0008219        ,0.00,6700000,17015390257.29,19081600082190000009,
2575,16/08/2019,08:58:06,16/08/2019,08:58:06,0247 UKT 1103618027 0819/0008957        ,0.00,3000000,17018390257.29,19081600089570000006,
2576,16/08/2019,08:58:12,16/08/2019,08:58:12,0247 UKT 1201617046 0819/0008219        ,0.00,4000000,17022390257.29,19081600082190000011,
2577,16/08/2019,08:59:33,16/08/2019,08:59:33,0247 UKT 1301617056 0819/0008302        ,0.00,3800000,17026190257.29,19081600083020000014,
2578,16/08/2019,08:59:55,16/08/2019,08:59:55,0247 UKT                                ,0.00,5100000,17031290257.29,19081699400010397983,
2579,16/08/2019,09:00:45,16/08/2019,09:00:45,0247 UKT 1101617082 0819/0016716        ,0.00,5300000,17036590257.29,19081600167160000009,
2580,16/08/2019,09:02:27,16/08/2019,09:02:27,0247 UKT 1314617018 0819/0008214        ,0.00,5200000,17041790257.29,19081600082140000003,
2581,16/08/2019,09:04:22,16/08/2019,09:04:22,0247 UKT 1303617017 0819/0007012        ,0.00,3950000,17045740257.29,19081600070120000018,
2582,16/08/2019,09:06:55,16/08/2019,09:06:55,0247 UKT 1201617014 0819/0018022        ,0.00,4000000,17049740257.29,19081600180220000017,
2583,16/08/2019,09:07:44,16/08/2019,09:07:44,0247 UKT 1107618148 0819/0008244        ,0.00,5100000,17054840257.29,19081600082440000004,
2584,16/08/2019,09:09:26,16/08/2019,09:09:26,0247 UKT 1102618006 0819/0018022        ,0.00,1000000,17055840257.29,19081600180220000019,
2585,16/08/2019,09:13:35,16/08/2019,09:13:35,0247 UKT 1303618061 0819/0007770        ,0.00,5200000,17061040257.29,19081600077700000005,
2586,16/08/2019,09:15:32,16/08/2019,09:15:32,0247 UKT 1602618067 0819/0007759        ,0.00,4700000,17065740257.29,19081600077590000006,
2587,16/08/2019,09:25:21,16/08/2019,09:25:21,0247 UKT 1306617026 0819/0013056        ,0.00,4500000,17070240257.29,19081600130560000014,
2588,16/08/2019,09:30:38,16/08/2019,09:30:38,0247 UKT 1939219007266 0819/0008588     ,0.00,3000000,17073240257.29,19081600085880000011,
2589,16/08/2019,09:32:02,16/08/2019,09:32:02,0247 UKT 1306618018 0819/0017017        ,0.00,4000000,17077240257.29,19081600170170000002,
2590,16/08/2019,09:36:05,16/08/2019,09:36:05,0247 UKT 1302618030 0819/0016668        ,0.00,7000000,17084240257.29,19081600166680000019,
2591,16/08/2019,09:38:54,16/08/2019,09:38:54,0247 UKT 1939219016035 0819/0018027     ,0.00,4600000,17088840257.29,19081600180270000014,
2592,16/08/2019,09:40:46,16/08/2019,09:40:46,0247 UKT 1602617168 0819/0013762        ,0.00,2700000,17091540257.29,19081600137620000021,
2593,16/08/2019,09:42:35,16/08/2019,09:42:35,0247 SPU 1939219010830 0819/0017002     ,0.00,6000000,17097540257.29,19081600170020000007,
2594,16/08/2019,09:43:05,16/08/2019,09:43:05,0247 UKT 1939219010830 0819/0017002     ,0.00,6000000,17103540257.29,19081600170020000009,
2595,16/08/2019,09:46:40,16/08/2019,09:46:40,0247 UKT 1603617119 0819/0013482        ,0.00,1000000,17104540257.29,19081600134820000004,
2596,16/08/2019,09:48:13,16/08/2019,09:48:13,0247 UKT 1209617055 0819/0007248        ,0.00,5900000,17110440257.29,19081600072480000011,
2597,16/08/2019,09:48:27,16/08/2019,09:48:27,0247 UKT 1801618150 0819/0016660        ,0.00,8200000,17118640257.29,19081600166600000020,
2598,16/08/2019,09:49:33,16/08/2019,09:49:33,0247 UKT 1308618054 0819/0012934        ,0.00,4150000,17122790257.29,19081600129340000009,
2599,16/08/2019,09:51:43,16/08/2019,09:51:43,0247 UKT                                ,0.00,5800000,17128590257.29,19081699310010800299,
2600,16/08/2019,09:52:34,16/08/2019,09:52:34,0247 UKT 1939219016745 0819/0008219     ,0.00,4500000,17133090257.29,19081600082190000019,
2601,16/08/2019,09:53:32,16/08/2019,09:53:32,0247 UKT 1106618050 0819/0009613        ,0.00,5100000,17138190257.29,19081600096130000010,
2602,16/08/2019,09:55:20,16/08/2019,09:55:20,0247 UKT 1209617018 0819/0008219        ,0.00,4500000,17142690257.29,19081600082190000021,
2603,16/08/2019,09:56:54,16/08/2019,09:56:54,0247 UKT 1305618034 0819/0008219        ,0.00,4000000,17146690257.29,19081600082190000023,
2604,16/08/2019,09:58:02,16/08/2019,09:58:02,0247 UKT 1107618142 0819/0011825        ,0.00,1000000,17147690257.29,19081600118250000045,
2605,16/08/2019,10:00:21,16/08/2019,10:00:21,0247 UKT 1107618086 0819/0009612        ,0.00,5100000,17152790257.29,19081600096120000012,
2606,16/08/2019,10:01:39,16/08/2019,10:01:39,0247 UKT 1107617226 0819/0009593        ,0.00,5100000,17157890257.29,19081600095930000006,
2607,16/08/2019,10:04:56,16/08/2019,10:04:56,0247 UKT 1104618056 0819/0010413        ,0.00,5300000,17163190257.29,19081600104130000004,
2608,16/08/2019,10:06:38,16/08/2019,10:06:38,0247 UKT 1939219007556 0819/0008219     ,0.00,500000,17163690257.29,19081600082190000027,
2609,16/08/2019,10:06:53,16/08/2019,10:06:53,0247 SPU 1939219007556 0819/0008219     ,0.00,7500000,17171190257.29,19081600082190000029,
2610,16/08/2019,10:08:14,16/08/2019,10:08:14,0247 UKT 1107617022 0819/0009593        ,0.00,3900000,17175090257.29,19081600095930000011,
2611,16/08/2019,10:08:28,16/08/2019,10:08:28,0247 UKT 1939219017063 0819/0008219     ,0.00,5900000,17180990257.29,19081600082190000031,
2612,16/08/2019,10:09:31,16/08/2019,10:09:31,0247 UKT 1304618047 0819/0009659        ,0.00,5200000,17186190257.29,19081600096590000016,
2613,16/08/2019,10:10:25,16/08/2019,10:10:25,0247 UKT 1801618081 0819/0017974        ,0.00,4000000,17190190257.29,19081600179740000051,
2614,16/08/2019,10:12:47,16/08/2019,10:12:47,0247 UKT 1107618131 0819/0008281        ,0.00,3000000,17193190257.29,19081600082810000010,
2615,16/08/2019,10:14:14,16/08/2019,10:14:14,0247 UKT 1213617031 0819/0011819        ,0.00,6200000,17199390257.29,19081600118190000025,
2616,16/08/2019,10:17:11,16/08/2019,10:17:11,0247 UKT 1104618066 0819/0010413        ,0.00,5300000,17204690257.29,19081600104130000006,
2617,16/08/2019,10:18:08,16/08/2019,10:18:08,0247 UKT 1103618032 0819/0012239        ,0.00,5300000,17209990257.29,19081600122390000007,
2618,16/08/2019,10:19:31,16/08/2019,10:19:31,0247 UKT 1602617125 0819/0016441        ,0.00,1000000,17210990257.29,19081600164410000024,
2619,16/08/2019,10:23:46,16/08/2019,10:23:46,0247 UKT 1601617025 0819/0008594        ,0.00,3400000,17214390257.29,19081600085940000005,
2620,16/08/2019,10:28:38,16/08/2019,10:28:38,0247 SPU 1939219007990 0819/0008219     ,0.00,10000000,17224390257.29,19081600082190000034,
2621,16/08/2019,10:31:06,16/08/2019,10:31:06,0247 UKT 1939219010544 0819/0008219     ,0.00,6700000,17231090257.29,19081600082190000036,
2622,16/08/2019,10:31:53,16/08/2019,10:31:53,0247 UKT 1601617041 0819/0008594        ,0.00,3400000,17234490257.29,19081600085940000007,
2623,16/08/2019,10:33:00,16/08/2019,10:33:00,0247 UKT 1601617180 0819/0018012        ,0.00,2700000,17237190257.29,19081600180120000024,
2624,16/08/2019,10:33:19,16/08/2019,10:33:19,0247 UKT 1106617070 0819/0017978        ,0.00,4500000,17241690257.29,19081600179780000044,
2625,16/08/2019,10:33:44,16/08/2019,10:33:44,0247 UKT 1308617039 0819/0018009        ,0.00,4150000,17245840257.29,19081600180090000020,
2626,16/08/2019,10:33:47,16/08/2019,10:33:47,0247 UKT 1201617036 0819/0008219        ,0.00,6000000,17251840257.29,19081600082190000038,
2627,16/08/2019,10:34:05,16/08/2019,10:34:05,0247 UKT 1603617126 0819/0016613        ,0.00,3200000,17255040257.29,19081600166130000032,
2628,16/08/2019,10:37:29,16/08/2019,10:37:29,0247 UKT 1939219007317 0819/0008219     ,0.00,2700000,17257740257.29,19081600082190000042,
2629,16/08/2019,10:38:33,16/08/2019,10:38:33,0247 UKT 1102617022 0819/0008219        ,0.00,3000000,17260740257.29,19081600082190000044,
2630,16/08/2019,10:42:48,16/08/2019,10:42:48,0247 UKT 1102617023 0819/0008219        ,0.00,4500000,17265240257.29,19081600082190000046,
2631,16/08/2019,10:44:14,16/08/2019,10:44:14,0247 UKT 1104617066 0819/0008298        ,0.00,5300000,17270540257.29,19081600082980000008,
2632,16/08/2019,10:45:19,16/08/2019,10:45:19,0247 UKT                                ,0.00,6000000,17276540257.29,19081699172010208501,
2633,16/08/2019,10:47:11,16/08/2019,10:47:11,0247 UKT 1603618014 0819/0008594        ,0.00,3200000,17279740257.29,19081600085940000009,
2634,16/08/2019,10:49:14,16/08/2019,10:49:14,0247 UKT 1209617072 0819/0013482        ,0.00,6700000,17286440257.29,19081600134820000008,
2635,16/08/2019,10:51:43,16/08/2019,10:51:43,0247 UKT 1603618004 0819/0008594        ,0.00,4300000,17290740257.29,19081600085940000011,
2636,16/08/2019,10:52:43,16/08/2019,10:52:43,0247 UKT 1303617004 0819/0008299        ,0.00,5200000,17295940257.29,19081600082990000040,
2637,16/08/2019,10:54:30,16/08/2019,10:54:30,0247 UKT 1211617004 0819/0011825        ,0.00,5000000,17300940257.29,19081600118250000050,
2638,16/08/2019,10:55:38,16/08/2019,10:55:38,0247 UKT 1201617033 0819/0005990        ,0.00,6000000,17306940257.29,19081600059900000024,
2639,16/08/2019,10:56:24,16/08/2019,10:56:24,0247 UKT 1107617034 0819/0016490        ,0.00,3900000,17310840257.29,19081600164900000148,
2640,16/08/2019,10:58:10,16/08/2019,10:58:10,0247 UKT 1107618021 0819/0013069        ,0.00,1000000,17311840257.29,19081600130690000041,
2641,16/08/2019,10:59:20,16/08/2019,10:59:20,0247 UKT 1601617019 0819/0016477        ,0.00,4000000,17315840257.29,19081600164770000023,
2642,16/08/2019,11:00:08,16/08/2019,11:00:08,0247 UKT 1313618022 0819/0007222        ,0.00,4000000,17319840257.29,19081600072220000012,
2643,16/08/2019,11:01:35,16/08/2019,11:01:35,0247 UKT 1103617084 0819/0008586        ,0.00,1000000,17320840257.29,19081600085860000024,
2644,16/08/2019,11:03:56,16/08/2019,11:03:56,0247 UKT 1801618075 0819/0013502        ,0.00,7200000,17328040257.29,19081600135020000016,
2645,16/08/2019,11:04:00,16/08/2019,11:04:00,0247 UKT 1939219008672 0819/0006664     ,0.00,5600000,17333640257.29,19081600066640000008,
2646,16/08/2019,11:04:20,16/08/2019,11:04:20,0247 UKT                                ,0.00,3900000,17337540257.29,19081699585010355932,
2647,16/08/2019,11:07:03,16/08/2019,11:07:03,0247 UKT 1303618017 0819/0008289        ,0.00,3950000,17341490257.29,19081600082890000028,
2648,16/08/2019,11:08:09,16/08/2019,11:08:09,0247 UKT 1603617059 0819/0008219        ,0.00,3200000,17344690257.29,19081600082190000054,
2649,16/08/2019,11:09:13,16/08/2019,11:09:13,0247 UKT 1205617065 0819/0008219        ,0.00,5900000,17350590257.29,19081600082190000056,
2650,16/08/2019,11:13:08,16/08/2019,11:13:08,0247 UKT 1939319000148 0819/0008219     ,0.00,8600000,17359190257.29,19081600082190000058,
2651,16/08/2019,11:14:46,16/08/2019,11:14:46,0247 UKT 1306618032 0819/0013056        ,0.00,4000000,17363190257.29,19081600130560000032,
2652,16/08/2019,11:19:34,16/08/2019,11:19:34,0247 UKT 1105617065 0819/0016618        ,0.00,3900000,17367090257.29,19081600166180000046,
2653,16/08/2019,11:23:13,16/08/2019,11:23:13,0247 UKT 1102618017 0819/0008219        ,0.00,3000000,17370090257.29,19081600082190000060,
2654,16/08/2019,11:24:10,16/08/2019,11:24:10,0247 UKT 1102618073 0819/0008219        ,0.00,3000000,17373090257.29,19081600082190000062,
2655,16/08/2019,11:24:35,16/08/2019,11:24:35,0247 UKT 1303618063 0819/0013466        ,0.00,3950000,17377040257.29,19081600134660000029,
2656,16/08/2019,11:33:27,16/08/2019,11:33:27,0247 UKT 1105617055 0819/0008264        ,0.00,3000000,17380040257.29,19081600082640000021,
2657,16/08/2019,11:51:59,16/08/2019,11:51:59,0247 UKT 1801618108 0819/0011932        ,0.00,8200000,17388240257.29,19081600119320000025,
2658,16/08/2019,11:55:36,16/08/2019,11:55:36,0247 UKT                                ,0.00,5100000,17393340257.29,19081699306010722687,
2659,16/08/2019,12:09:54,16/08/2019,12:09:54,0247 UKT                                ,0.00,3900000,17397240257.29,19081699113810811732,
2660,16/08/2019,12:45:01,16/08/2019,12:45:01,0247 UKT 1305617030 0819/0013462        ,0.00,6200000,17403440257.29,19081600134620000027,
2661,16/08/2019,13:07:24,16/08/2019,13:07:24,0247 UKT 1101618039 0819/0008219        ,0.00,3000000,17406440257.29,19081600082190000064,
2662,16/08/2019,13:09:24,16/08/2019,13:09:24,0247 UKT 1306618012 0819/0013497        ,0.00,4000000,17410440257.29,19081600134970000062,
2663,16/08/2019,13:11:38,16/08/2019,13:11:38,0247 UKT 1207617060 0819/0007367        ,0.00,6700000,17417140257.29,19081600073670000020,
2664,16/08/2019,13:12:50,16/08/2019,13:12:50,0247 UKT 1107617258 0819/0012234        ,0.00,3900000,17421040257.29,19081600122340000059,
2665,16/08/2019,13:13:40,16/08/2019,13:13:40,0247 UKT 1801618035 0819/0008219        ,0.00,6200000,17427240257.29,19081600082190000066,
2666,16/08/2019,13:16:19,16/08/2019,13:16:19,0247 UKT 1308618039 0819/0008219        ,0.00,6250000,17433490257.29,19081600082190000068,
2667,16/08/2019,13:17:58,16/08/2019,13:17:58,0247 UKT 1801617298 0819/0008219        ,0.00,4000000,17437490257.29,19081600082190000070,
2668,16/08/2019,13:18:31,16/08/2019,13:18:31,0247 UKT 1107617165 0819/0007222        ,0.00,5100000,17442590257.29,19081600072220000026,
2669,16/08/2019,13:19:17,16/08/2019,13:19:17,0247 UKT 1102617059 0819/0008219        ,0.00,1000000,17443590257.29,19081600082190000072,
2670,16/08/2019,13:20:47,16/08/2019,13:20:47,0247 UKT 1102617031 0819/0008219        ,0.00,4500000,17448090257.29,19081600082190000074,
2671,16/08/2019,13:22:07,16/08/2019,13:22:07,0247 UKT 1601617182 0819/0008244        ,0.00,4700000,17452790257.29,19081600082440000035,
2672,16/08/2019,13:22:27,16/08/2019,13:22:27,0247 UKT 1601618044 0819/0008219        ,0.00,4700000,17457490257.29,19081600082190000076,
2673,16/08/2019,13:23:51,16/08/2019,13:23:51,0247 UKT 1302617068 0819/0017968        ,0.00,3800000,17461290257.29,19081600179680000042,
2674,16/08/2019,13:24:10,16/08/2019,13:24:10,0247 UKT 1801617170 0819/0008219        ,0.00,4000000,17465290257.29,19081600082190000078,
2675,16/08/2019,13:24:26,16/08/2019,13:24:26,0247 UKT 1210618056 0819/0009746        ,0.00,6900000,17472190257.29,19081600097460000014,
2676,16/08/2019,13:25:22,16/08/2019,13:25:22,0247 UKT 1601617036 0819/0008594        ,0.00,3400000,17475590257.29,19081600085940000021,
2677,16/08/2019,13:28:08,16/08/2019,13:28:08,0247 UKT 1102617058 0819/0008219        ,0.00,5100000,17480690257.29,19081600082190000080,
2678,16/08/2019,13:28:22,16/08/2019,13:28:22,0247 UKT 1603617065 0819/0013733        ,0.00,3200000,17483890257.29,19081600137330000051,
2679,16/08/2019,13:29:29,16/08/2019,13:29:29,0247 UKT 1101617062 0819/0013056        ,0.00,4000000,17487890257.29,19081600130560000052,
2680,16/08/2019,13:30:02,16/08/2019,13:30:02,0247 UKT 1306617016 0819/0013469        ,0.00,4000000,17491890257.29,19081600134690000026,
2681,16/08/2019,13:30:05,16/08/2019,13:30:05,0247 UKT 1308617020 0819/0016484        ,0.00,4150000,17496040257.29,19081600164840000084,
2682,16/08/2019,13:31:44,16/08/2019,13:31:44,0247 UKT 1602617193 0819/0008594        ,0.00,4700000,17500740257.29,19081600085940000024,
2683,16/08/2019,13:32:17,16/08/2019,13:32:17,0247 UKT 1601618037 0819/0008219        ,0.00,4700000,17505440257.29,19081600082190000082,
2684,16/08/2019,13:33:24,16/08/2019,13:33:24,0247 UKT 1602618062 0819/0008219        ,0.00,1000000,17506440257.29,19081600082190000084,
2685,16/08/2019,13:35:25,16/08/2019,13:35:25,0247 UKT 1207618012 0819/0008260        ,0.00,6700000,17513140257.29,19081600082600000034,
2686,16/08/2019,13:36:44,16/08/2019,13:36:44,0247 UKT 1107617029 0819/0008219        ,0.00,5100000,17518240257.29,19081600082190000086,
2687,16/08/2019,13:37:05,16/08/2019,13:37:05,0247 UKT 1308617023 0819/0018005        ,0.00,6250000,17524490257.29,19081600180050000024,
2688,16/08/2019,13:37:22,16/08/2019,13:37:22,0247 UKT FIRDA/0008941                  ,0.00,5100000,17529590257.29,19081600089410000028,
2689,16/08/2019,13:37:51,16/08/2019,13:37:51,0247 UKT 1601617102 0819/0013463        ,0.00,3400000,17532990257.29,19081600134630000085,
2690,16/08/2019,13:38:17,16/08/2019,13:38:17,0247 UKT 1106618067 0819/0008219        ,0.00,4500000,17537490257.29,19081600082190000088,
2691,16/08/2019,13:38:41,16/08/2019,13:38:41,0247 UKT 1107617241 0819/0008574        ,0.00,3000000,17540490257.29,19081600085740000095,
2692,16/08/2019,13:40:04,16/08/2019,13:40:04,0247 UKT 1603617133 0819/0005992        ,0.00,6500000,17546990257.29,19081600059920000021,
2693,16/08/2019,13:40:28,16/08/2019,13:40:28,0247 UKT 1210617046 0819/0017989        ,0.00,5500000,17552490257.29,19081600179890000031,
2694,16/08/2019,13:40:43,16/08/2019,13:40:43,0247 UKT 1801618091 0819/0008219        ,0.00,9300000,17561790257.29,19081600082190000090,
2695,16/08/2019,13:41:27,16/08/2019,13:41:27,0247 UKT 1202617050 0819/0013069        ,0.00,3900000,17565690257.29,19081600130690000063,
2696,16/08/2019,13:45:32,16/08/2019,13:45:32,0247 UKT 1301617064 0819/0007901        ,0.00,3800000,17569490257.29,19081600079010000038,
2697,16/08/2019,13:49:05,16/08/2019,13:49:05,0247 UKT 1107618115 0819/0008574        ,0.00,3900000,17573390257.29,19081600085740000097,
2698,16/08/2019,13:50:05,16/08/2019,13:50:05,0247 UKT 1304617038 0819/0012937        ,0.00,6200000,17579590257.29,19081600129370000004,
2699,16/08/2019,13:53:55,16/08/2019,13:53:55,0247 UKT 1102617088 0819/0016525        ,0.00,3000000,17582590257.29,19081600165250000036,
2700,16/08/2019,13:54:25,16/08/2019,13:54:25,0247 UKT 1205618009 0819/0018011        ,0.00,3900000,17586490257.29,19081600180110000140,
2701,16/08/2019,13:55:05,16/08/2019,13:55:05,0247 UKT 1801617097 0819/0008941        ,0.00,4000000,17590490257.29,19081600089410000037,
2702,16/08/2019,13:55:52,16/08/2019,13:55:52,0247 UKT 1605618030 0819/0018018        ,0.00,6500000,17596990257.29,19081600180180000029,
2703,16/08/2019,13:57:46,16/08/2019,13:57:46,0247 UKT 1307617029 0819/0013062        ,0.00,6250000,17603240257.29,19081600130620000092,
2704,16/08/2019,13:59:02,16/08/2019,13:59:02,0247 UKT 1602617172 0819/0016587        ,0.00,2700000,17605940257.29,19081600165870000031,
2705,16/08/2019,13:59:38,16/08/2019,13:59:38,0247 UKT 1206617013 0819/0008275        ,0.00,4500000,17610440257.29,19081600082750000115,
2706,16/08/2019,13:59:42,16/08/2019,13:59:42,0247 UKT 1203617063 0819/0008547        ,0.00,3700000,17614140257.29,19081600085470000011,
2707,16/08/2019,14:01:01,16/08/2019,14:01:01,0247 UKT 1210617006 0819/0012239        ,0.00,4600000,17618740257.29,19081600122390000011,
2708,16/08/2019,14:03:54,16/08/2019,14:03:54,0247 UKT 1104618065 0819/0008219        ,0.00,4000000,17622740257.29,19081600082190000095,
2709,16/08/2019,14:09:28,16/08/2019,14:09:28,0247 UKT 1304618018 0819/0008219        ,0.00,3950000,17626690257.29,19081600082190000097,
2710,16/08/2019,14:10:14,16/08/2019,14:10:14,0247 UKT 1107617146 0819/0016491        ,0.00,3900000,17630590257.29,19081600164910000099,
2711,16/08/2019,14:10:15,16/08/2019,14:10:15,0247 UKT 1308617069 0819/0010423        ,0.00,4150000,17634740257.29,19081600104230000041,
2712,16/08/2019,14:10:39,16/08/2019,14:10:39,0247 UKT 1104617065 0819/0013482        ,0.00,5300000,17640040257.29,19081600134820000026,
2713,16/08/2019,14:11:32,16/08/2019,14:11:32,0247 UKT 1301617073 0819/0010423        ,0.00,500000,17640540257.29,19081600104230000043,
2714,16/08/2019,14:15:10,16/08/2019,14:15:10,0247 UKT 1301617014 0819/0008219        ,0.00,3800000,17644340257.29,19081600082190000101,
2715,16/08/2019,14:16:14,16/08/2019,14:16:14,0247 UKT                                ,0.00,5250000,17649590257.29,19081699136010720897,
2716,16/08/2019,14:16:53,16/08/2019,14:16:53,0247 UKT 1602617024 0819/0013452        ,0.00,3400000,17652990257.29,19081600134520000044,
2717,16/08/2019,14:18:05,16/08/2019,14:18:05,0247 UKT 1104617072 0819/0010403        ,0.00,4000000,17656990257.29,19081600104030000190,
2718,16/08/2019,14:18:41,16/08/2019,14:18:41,0247 UKT 1205617015 0819/0008219        ,0.00,3900000,17660890257.29,19081600082190000103,
2719,16/08/2019,14:19:19,16/08/2019,14:19:19,0247 UKT 1801618028 0819/0007894        ,0.00,4000000,17664890257.29,19081600078940000017,
2720,16/08/2019,14:20:15,16/08/2019,14:20:15,0247 UKT 1210617021 0819/0008219        ,0.00,1000000,17665890257.29,19081600082190000106,
2721,16/08/2019,14:20:20,16/08/2019,14:20:20,0247 UKT 1602617190 0819/0008594        ,0.00,3400000,17669290257.29,19081600085940000035,
2722,16/08/2019,14:20:40,16/08/2019,14:20:40,0247 UKT 1304618034 0819/0016671        ,0.00,7500000,17676790257.29,19081600166710000044,
2723,16/08/2019,14:20:58,16/08/2019,14:20:58,0247 UKT 1209617058 0819/0018007        ,0.00,4500000,17681290257.29,19081600180070000038,
2724,16/08/2019,14:21:18,16/08/2019,14:21:18,0247 UKT 1210618017 0819/0008219        ,0.00,5500000,17686790257.29,19081600082190000108,
2725,16/08/2019,14:22:21,16/08/2019,14:22:21,0247 UKT 1107618157 0819/0008219        ,0.00,5100000,17691890257.29,19081600082190000110,
2726,16/08/2019,14:27:21,16/08/2019,14:27:21,0247 UKT 1303618076 0819/0008219        ,0.00,3950000,17695840257.29,19081600082190000112,
2727,16/08/2019,14:27:46,16/08/2019,14:27:46,0247 UKT 1801617277 0819/0011914        ,0.00,7200000,17703040257.29,19081600119140000014,
2728,16/08/2019,14:29:12,16/08/2019,14:29:12,0247 UKT 1102617067 0819/0016437        ,0.00,3000000,17706040257.29,19081600164370000040,
2729,16/08/2019,14:31:00,16/08/2019,14:31:00,0247 UKT 1106618010 0819/0008219        ,0.00,5100000,17711140257.29,19081600082190000114,
2730,16/08/2019,14:34:20,16/08/2019,14:34:20,0247 UKT 1601617038 0819/0016466        ,0.00,2700000,17713840257.29,19081600164660000141,
2731,16/08/2019,14:37:06,16/08/2019,14:37:06,0247 UKT 1201617047 0819/0013498        ,0.00,4000000,17717840257.29,19081600134980000057,
2732,16/08/2019,14:37:40,16/08/2019,14:37:40,0247 UKT                                ,0.00,9300000,17727140257.29,19081699189010882115,
2733,16/08/2019,14:43:26,16/08/2019,14:43:26,0247 UKT 1303618026 0819/0013447        ,0.00,3950000,17731090257.29,19081600134470000053,
2734,16/08/2019,14:44:49,16/08/2019,14:44:49,0247 UKT 1302618019 0819/0008219        ,0.00,3800000,17734890257.29,19081600082190000116,
2735,16/08/2019,14:46:06,16/08/2019,14:46:06,0247 UKT 1102617095 0819/0008219        ,0.00,6400000,17741290257.29,19081600082190000118,
2736,16/08/2019,14:46:21,16/08/2019,14:46:21,0247 UKT 1604618058 0819/0009069        ,0.00,4300000,17745590257.29,19081600090690000112,
2737,16/08/2019,14:47:46,16/08/2019,14:47:46,0247 UKT 1801617231 0819/0008219        ,0.00,8200000,17753790257.29,19081600082190000120,
2738,16/08/2019,14:51:49,16/08/2019,14:51:49,0247 UKT 1107618156 0819/0008586        ,0.00,5100000,17758890257.29,19081600085860000038,
2739,16/08/2019,14:53:43,16/08/2019,14:53:43,0247 UKT 1801617149 0819/0009659        ,0.00,4000000,17762890257.29,19081600096590000029,
2740,16/08/2019,14:55:16,16/08/2019,14:55:16,0247 UKT 1102617035 0819/0008219        ,0.00,4500000,17767390257.29,19081600082190000124,
2741,16/08/2019,14:55:40,16/08/2019,14:55:40,0247 UKT                                ,0.00,5100000,17772490257.29,19081699113810015603,
2742,16/08/2019,14:56:43,16/08/2019,14:56:43,0247 UKT 1207618035 0819/0013678        ,0.00,4500000,17776990257.29,19081600136780000092,
2743,16/08/2019,14:58:16,16/08/2019,14:58:16,0247 UKT 1314618026 0819/0008219        ,0.00,6400000,17783390257.29,19081600082190000127,
2744,16/08/2019,14:59:56,16/08/2019,14:59:56,0247 UKT                                ,0.00,5100000,17788490257.29,19081699508010046112,
2745,16/08/2019,15:00:31,16/08/2019,15:00:31,0247 UKT 1801617268 0819/0008219        ,0.00,1000000,17789490257.29,19081600082190000130,
2746,16/08/2019,15:01:05,16/08/2019,15:01:05,0247 UKT 1106618039 0819/0012936        ,0.00,3900000,17793390257.29,19081600129360000052,
2747,16/08/2019,15:10:04,16/08/2019,15:10:04,0247 UKT 1801617075 0819/0006664        ,0.00,4000000,17797390257.29,19081600066640000018,
2748,16/08/2019,15:15:00,16/08/2019,15:15:00,0247 UKT 1201618050 0819/0013056        ,0.00,4700000,17802090257.29,19081600130560000065,
2749,16/08/2019,15:16:48,16/08/2019,15:16:48,0247 UKT 1213617036 0819/0018010        ,0.00,1000000,17803090257.29,19081600180100000017,
2750,16/08/2019,15:20:21,16/08/2019,15:20:21,0247 UKT 1801618110 0819/0018027        ,0.00,4000000,17807090257.29,19081600180270000048,
2751,16/08/2019,15:38:28,16/08/2019,15:38:28,0247 UKT                                ,0.00,5100000,17812190257.29,19081699132010330884,
2752,16/08/2019,16:03:01,16/08/2019,16:03:01,0247 UKT                                ,0.00,5100000,17817290257.29,19081699570010510126,
2753,16/08/2019,17:45:12,16/08/2019,17:45:12,0247 UKT                                ,0.00,6100000,17823390257.29,19081699001250263190,
2754,16/08/2019,18:48:49,16/08/2019,18:48:49,0247 UKT                                ,0.00,5000000,17828390257.29,19081699368010667881,
2755,17/08/2019,12:07:48,17/08/2019,12:07:48,0247 UKT                                ,0.00,3000000,17831390257.29,19081799590010828657,
2756,17/08/2019,16:15:31,17/08/2019,16:15:31,0247 UKT                                ,0.00,6400000,17837790257.29,19081799295010421478,
2757,17/08/2019,16:20:28,17/08/2019,16:20:28,0247 UKT                                ,0.00,5100000,17842890257.29,19081799016820452573,
2758,17/08/2019,18:27:37,17/08/2019,18:27:37,0247 UKT                                ,0.00,3900000,17846790257.29,19081799001120226115,
2759,17/08/2019,18:56:51,17/08/2019,18:56:51,0247 UKT                                ,0.00,1000000,17847790257.29,19081799121140426200,
2760,17/08/2019,20:46:15,17/08/2019,20:46:15,0247 UKT                                ,0.00,3900000,17851690257.29,19081799169010120988,
2761,18/08/2019,10:35:51,18/08/2019,10:35:51,0247 UKT                                ,0.00,5100000,17856790257.29,19081899661010497580,
2762,18/08/2019,14:55:52,18/08/2019,14:55:52,0247 UKT                                ,0.00,5100000,17861890257.29,19081899105610055377,
2763,18/08/2019,15:50:25,18/08/2019,15:50:25,0247 UKT                                ,0.00,5100000,17866990257.29,19081899114810370754,
2764,18/08/2019,16:01:03,18/08/2019,16:01:03,0247 UKT                                ,0.00,4700000,17871690257.29,19081899391010433647,
2765,18/08/2019,19:29:19,18/08/2019,19:29:19,0247 UKT                                ,0.00,4500000,17876190257.29,19081899140010737140,
2766,18/08/2019,20:50:28,18/08/2019,20:50:28,0247 UKT                                ,0.00,4000000,17880190257.29,19081899105710231703,
2767,19/08/2019,08:09:53,19/08/2019,08:09:53,0247 UKT 1303618075 0819/0016995        ,0.00,4500000,17884690257.29,19081900169950000012,
2768,19/08/2019,08:13:29,19/08/2019,08:13:29,0247 UKT 1103618041 0819/0009558        ,0.00,1000000,17885690257.29,19081900095580000002,
2769,19/08/2019,08:15:39,19/08/2019,08:15:39,0247 UKT 1208618035 0819/0008219        ,0.00,1000000,17886690257.29,19081900082190000002,
2770,19/08/2019,08:23:34,19/08/2019,08:23:34,0247 UKT 1101617102 0819/0016491        ,0.00,3000000,17889690257.29,19081900164910000002,
2771,19/08/2019,08:23:47,19/08/2019,08:23:47,0247 UKT 1107617209 0819/0012941        ,0.00,3000000,17892690257.29,19081900129410000002,
2772,19/08/2019,08:24:30,19/08/2019,08:24:30,0247 UKT 1106618071 0819/0013063        ,0.00,4500000,17897190257.29,19081900130630000010,
2773,19/08/2019,08:26:21,19/08/2019,08:26:21,0247 UKT 1308618025 0819/0017968        ,0.00,4150000,17901340257.29,19081900179680000002,
2774,19/08/2019,08:29:59,19/08/2019,08:29:59,0247 UKT 1105617009 0819/0013786        ,0.00,6400000,17907740257.29,19081900137860000007,
2775,19/08/2019,08:30:16,19/08/2019,08:30:16,0247 UKT 1313618033 0819/0013066        ,0.00,6200000,17913940257.29,19081900130660000004,
2776,19/08/2019,08:36:19,19/08/2019,08:36:19,0247 UKT 1107618128 0819/0016491        ,0.00,3000000,17916940257.29,19081900164910000006,
2777,19/08/2019,08:36:55,19/08/2019,08:36:55,0247 UKT 1211617052 0819/0016441        ,0.00,3700000,17920640257.29,19081900164410000008,
2778,19/08/2019,08:37:37,19/08/2019,08:37:37,0247 UKT 1601617104 0819/0007348        ,0.00,2700000,17923340257.29,19081900073480000007,
2779,19/08/2019,08:39:05,19/08/2019,08:39:05,0247 UKT 1103617102 0819/0017994        ,0.00,4700000,17928040257.29,19081900179940000008,
2780,19/08/2019,08:40:09,19/08/2019,08:40:09,0247 UKT 1102618066 0819/0007348        ,0.00,6400000,17934440257.29,19081900073480000010,
2781,19/08/2019,08:43:20,19/08/2019,08:43:20,0247 UKT 1205618069 0819/0012490        ,0.00,3900000,17938340257.29,19081900124900000004,
2782,19/08/2019,08:44:40,19/08/2019,08:44:40,0247 UKT 1601618018 0819/0011806        ,0.00,2700000,17941040257.29,19081900118060000008,
2783,19/08/2019,08:46:56,19/08/2019,08:46:56,0247 UKT 1305618016 0819/0008219        ,0.00,4000000,17945040257.29,19081900082190000021,
2784,19/08/2019,08:47:02,19/08/2019,08:47:02,0247 UKT 1106617064 0819/0008275        ,0.00,4500000,17949540257.29,19081900082750000008,
2785,19/08/2019,08:49:45,19/08/2019,08:49:45,0247 UKT 1603617069 0819/0013842        ,0.00,3200000,17952740257.29,19081900138420000015,
2786,19/08/2019,08:51:08,19/08/2019,08:51:08,0247 UKT 1107617055 0819/0018013        ,0.00,5100000,17957840257.29,19081900180130000004,
2787,19/08/2019,08:51:23,19/08/2019,08:51:23,0247 UKT 1204617041 0819/0011831        ,0.00,5900000,17963740257.29,19081900118310000011,
2788,19/08/2019,08:53:02,19/08/2019,08:53:02,0247 UKT 1603617017 0819/0008594        ,0.00,3200000,17966940257.29,19081900085940000006,
2789,19/08/2019,08:56:31,19/08/2019,08:56:31,0247 UKT 1107618121 0819/0016647        ,0.00,500000,17967440257.29,19081900166470000006,
2790,19/08/2019,08:57:11,19/08/2019,08:57:11,0247 UKT 1603617056 0819/0009247        ,0.00,6500000,17973940257.29,19081900092470000018,
2791,19/08/2019,08:57:25,19/08/2019,08:57:25,0247 UKT 1206617023 0819/0007770        ,0.00,4500000,17978440257.29,19081900077700000002,
2792,19/08/2019,09:05:47,19/08/2019,09:05:47,0247 UKT 1302617061 0819/0008594        ,0.00,5000000,17983440257.29,19081900085940000008,
2793,19/08/2019,09:12:40,19/08/2019,09:12:40,0247 UKT                                ,0.00,6900000,17990340257.29,19081999248010274701,
2794,19/08/2019,09:13:16,19/08/2019,09:13:16,0247 UKT 1302618050 0819/SALSA GHINA KHA,0.00,3800000,17994140257.29,19081900181400000049,
2795,19/08/2019,09:14:24,19/08/2019,09:14:24,0247 UKT                                ,0.00,6900000,18001040257.29,19081999354010287391,
2796,19/08/2019,09:15:36,19/08/2019,09:15:36,0247 UKT 1202617035 0819/0009621        ,0.00,3900000,18004940257.29,19081900096210000028,
2797,19/08/2019,09:21:01,19/08/2019,09:21:01,0247 UKT 1202618026 0819/0009621        ,0.00,5200000,18010140257.29,19081900096210000030,
2798,19/08/2019,09:21:39,19/08/2019,09:21:39,0247 UKT 1106617053 0819/0017002        ,0.00,3000000,18013140257.29,19081900170020000007,
2799,19/08/2019,09:23:51,19/08/2019,09:23:51,0247 UKT 1101617048 0819/0017017        ,0.00,500000,18013640257.29,19081900170170000006,
2800,19/08/2019,09:24:44,19/08/2019,09:24:44,0247 UKT 1103617083 0819/0008219        ,0.00,5300000,18018940257.29,19081900082190000023,
2801,19/08/2019,09:25:05,19/08/2019,09:25:05,0247 UKT 1207617017 0819/0010935        ,0.00,6700000,18025640257.29,19081900109350000022,
2802,19/08/2019,09:25:47,19/08/2019,09:25:47,0247 UKT 1106617052 0819/0006645        ,0.00,3900000,18029540257.29,19081900066450000018,
2803,19/08/2019,09:26:56,19/08/2019,09:26:56,0247 UKT 1107618111 0819/0018000        ,0.00,3900000,18033440257.29,19081900180000000022,
2804,19/08/2019,09:27:29,19/08/2019,09:27:29,0247 UKT 1801617033 0819/0008219        ,0.00,4000000,18037440257.29,19081900082190000025,
2805,19/08/2019,09:28:15,19/08/2019,09:28:15,0247 UKT 1306618027 0819/0013785        ,0.00,4000000,18041440257.29,19081900137850000009,
2806,19/08/2019,09:28:21,19/08/2019,09:28:21,0247 UKT 1201617034 0819/0008219        ,0.00,500000,18041940257.29,19081900082190000027,
2807,19/08/2019,09:30:27,19/08/2019,09:30:27,0247 UKT 1308617022 0819/0006338        ,0.00,8000000,18049940257.29,19081900063380000066,
2808,19/08/2019,09:30:57,19/08/2019,09:30:57,0247 UKT 1103617094 0819/0008219        ,0.00,5300000,18055240257.29,19081900082190000029,
2809,19/08/2019,09:31:10,19/08/2019,09:31:10,0247 UKT 1601617137 0819/0010956        ,0.00,4700000,18059940257.29,19081900109560000069,
2810,19/08/2019,09:34:39,19/08/2019,09:34:39,0247 UKT 1203617057 0819/0013482        ,0.00,5900000,18065840257.29,19081900134820000010,
2811,19/08/2019,09:38:13,19/08/2019,09:38:13,0247 UKT 1104617081 0819/0008219        ,0.00,3000000,18068840257.29,19081900082190000033,
2812,19/08/2019,09:38:16,19/08/2019,09:38:16,0247 UKT 1602617203 0819/0012236        ,0.00,4700000,18073540257.29,19081900122360000006,
2813,19/08/2019,09:38:20,19/08/2019,09:38:20,0247 UKT 1209617034 0819/0010971        ,0.00,4500000,18078040257.29,19081900109710000006,
2814,19/08/2019,09:41:56,19/08/2019,09:41:56,0247 UKT 1801618121 0819/0017966        ,0.00,8200000,18086240257.29,19081900179660000002,
2815,19/08/2019,09:42:47,19/08/2019,09:42:47,0247 UKT 1106617058 0819/0008298        ,0.00,5100000,18091340257.29,19081900082980000008,
2816,19/08/2019,09:44:18,19/08/2019,09:44:18,0247 UKT 1102618033 0819/0017963        ,0.00,3900000,18095240257.29,19081900179630000015,
2817,19/08/2019,09:46:52,19/08/2019,09:46:52,0247 UKT                                ,0.00,3000000,18098240257.29,19081999292010540143,
2818,19/08/2019,09:49:22,19/08/2019,09:49:22,0247 UKT 1103617013 0819/0008219        ,0.00,4000000,18102240257.29,19081900082190000038,
2819,19/08/2019,09:50:38,19/08/2019,09:50:38,0247 UKT 1107617191 0819/0018000        ,0.00,5100000,18107340257.29,19081900180000000030,
2820,19/08/2019,09:51:17,19/08/2019,09:51:17,0247 UKT 1205617058 0819/0012246        ,0.00,5900000,18113240257.29,19081900122460000015,
2821,19/08/2019,09:51:18,19/08/2019,09:51:18,0247 UKT 1105618007 0819/0008219        ,0.00,3000000,18116240257.29,19081900082190000040,
2822,19/08/2019,09:51:20,19/08/2019,09:51:20,0247 UKT 1102617107 0819/0007348        ,0.00,5100000,18121340257.29,19081900073480000014,
2823,19/08/2019,09:52:28,19/08/2019,09:52:28,0247 UKT 1105618009 0819/0008219        ,0.00,3000000,18124340257.29,19081900082190000042,
2824,19/08/2019,09:54:05,19/08/2019,09:54:05,0247 UKT 1602618038 0819/0008219        ,0.00,4700000,18129040257.29,19081900082190000045,
2825,19/08/2019,09:54:57,19/08/2019,09:54:57,0247 UKT 1103617056 0819/0009593        ,0.00,4000000,18133040257.29,19081900095930000026,
2826,19/08/2019,09:55:29,19/08/2019,09:55:29,0247 UKT 1601618091 0819/0008219        ,0.00,500000,18133540257.29,19081900082190000047,
2827,19/08/2019,09:56:47,19/08/2019,09:56:47,0247 UKT 1303618003 0819/0006338        ,0.00,3950000,18137490257.29,19081900063380000074,
2828,19/08/2019,09:58:00,19/08/2019,09:58:00,0247 UKT 1102617084 0819/0013446        ,0.00,3000000,18140490257.29,19081900134460000016,
2829,19/08/2019,09:58:00,19/08/2019,09:58:00,0247 UKT 1308618012 0819/0008281        ,0.00,5250000,18145740257.29,19081900082810000010,
2830,19/08/2019,09:59:50,19/08/2019,09:59:50,0247 UKT 1801618083 0819/0008264        ,0.00,4000000,18149740257.29,19081900082640000019,
2831,19/08/2019,10:05:32,19/08/2019,10:05:32,0247 UKT 1107617157 0819/0009612        ,0.00,5100000,18154840257.29,19081900096120000024,
2832,19/08/2019,10:07:44,19/08/2019,10:07:44,0247 UKT 1210617007 0819/0008219        ,0.00,4600000,18159440257.29,19081900082190000050,
2833,19/08/2019,10:08:37,19/08/2019,10:08:37,0247 UKT 1201617015 0819/0016660        ,0.00,6700000,18166140257.29,19081900166600000031,
2834,19/08/2019,10:09:02,19/08/2019,10:09:02,0247 UKT 1103617109 0819/0008219        ,0.00,500000,18166640257.29,19081900082190000052,
2835,19/08/2019,10:10:14,19/08/2019,10:10:14,0247 UKT 1204617042 0819/0009612        ,0.00,1000000,18167640257.29,19081900096120000027,
2836,19/08/2019,10:11:12,19/08/2019,10:11:12,0247 UKT 1308617057 0819/0008551        ,0.00,10000000,18177640257.29,19081900085510000005,
2837,19/08/2019,10:11:19,19/08/2019,10:11:19,0247 UKT 1107617106 0819/0013080        ,0.00,3000000,18180640257.29,19081900130800000043,
2838,19/08/2019,10:12:34,19/08/2019,10:12:34,0247 UKT 1313618013 0819/0012489        ,0.00,6200000,18186840257.29,19081900124890000010,
2839,19/08/2019,10:12:59,19/08/2019,10:12:59,0247 UKT 1103618044 0819/0011952        ,0.00,3000000,18189840257.29,19081900119520000031,
2840,19/08/2019,10:13:04,19/08/2019,10:13:04,0247 UKT 1101617023 0819/0013785        ,0.00,4000000,18193840257.29,19081900137850000021,
2841,19/08/2019,10:13:40,19/08/2019,10:13:40,0247 UKT 1205618036 0819/0017977        ,0.00,3900000,18197740257.29,19081900179770000031,
2842,19/08/2019,10:15:44,19/08/2019,10:15:44,0247 UKT 1107618022 0819/0012882        ,0.00,1000000,18198740257.29,19081900128820000022,
2843,19/08/2019,10:16:25,19/08/2019,10:16:25,0247 UKT 1308618050 0819/0010971        ,0.00,6250000,18204990257.29,19081900109710000015,
2844,19/08/2019,10:17:14,19/08/2019,10:17:14,0247 UKT 1107617052 0819/0007248        ,0.00,3900000,18208890257.29,19081900072480000007,
2845,19/08/2019,10:17:36,19/08/2019,10:17:36,0247 UKT 1308617059 0819/0017994        ,0.00,6250000,18215140257.29,19081900179940000054,
2846,19/08/2019,10:18:24,19/08/2019,10:18:24,0247 UKT 1601617159 0819/0013056        ,0.00,2700000,18217840257.29,19081900130560000004,
2847,19/08/2019,10:19:17,19/08/2019,10:19:17,0247 UKT 1103617061 0819/0016993        ,0.00,4700000,18222540257.29,19081900169930000016,
2848,19/08/2019,10:19:30,19/08/2019,10:19:30,0247 UKT 1203618021 0819/0016491        ,0.00,5600000,18228140257.29,19081900164910000026,
2849,19/08/2019,10:20:02,19/08/2019,10:20:02,0247 UKT 1105617051 0819/0018004        ,0.00,5800000,18233940257.29,19081900180040000006,
2850,19/08/2019,10:24:13,19/08/2019,10:24:13,0247 UKT 1204618042 0819/0016722        ,0.00,5900000,18239840257.29,19081900167220000029,
2851,19/08/2019,10:25:32,19/08/2019,10:25:32,0247 UKT 1314617021 0819/0016657        ,0.00,9000000,18248840257.29,19081900166570000030,
2852,19/08/2019,10:27:08,19/08/2019,10:27:08,0247 UKT 1106618049 0819/0007901        ,0.00,5100000,18253940257.29,19081900079010000014,
2853,19/08/2019,10:28:36,19/08/2019,10:28:36,0247 UKT 1304617042 0819/0017994        ,0.00,4500000,18258440257.29,19081900179940000058,
2854,19/08/2019,10:28:49,19/08/2019,10:28:49,0247 UKT 1104617058 0819/0018139        ,0.00,3000000,18261440257.29,19081900181390000009,
2855,19/08/2019,10:29:34,19/08/2019,10:29:34,0247 UKT 1304617043 0819/0013788        ,0.00,7500000,18268940257.29,19081900137880000007,
2856,19/08/2019,10:30:27,19/08/2019,10:30:27,0247 UKT 1103617082 0819/0013482        ,0.00,6700000,18275640257.29,19081900134820000016,
2857,19/08/2019,10:31:04,19/08/2019,10:31:04,0247 UKT 1313618004 0819/0018007        ,0.00,4000000,18279640257.29,19081900180070000015,
2858,19/08/2019,10:32:37,19/08/2019,10:32:37,0247 UKT 1303617059 0819/0016629        ,0.00,3950000,18283590257.29,19081900166290000005,
2859,19/08/2019,10:33:17,19/08/2019,10:33:17,0247 UKT 1602618008 0819/0009750        ,0.00,5700000,18289290257.29,19081900097500000050,
2860,19/08/2019,10:33:52,19/08/2019,10:33:52,0247 UKT 1603618033 0819/0008219        ,0.00,3200000,18292490257.29,19081900082190000054,
2861,19/08/2019,10:35:04,19/08/2019,10:35:04,0247 UKT 1205618095 0819/0016491        ,0.00,4500000,18296990257.29,19081900164910000031,
2862,19/08/2019,10:35:22,19/08/2019,10:35:22,0247 UKT 1103618009 0819/0013791        ,0.00,3000000,18299990257.29,19081900137910000033,
2863,19/08/2019,10:36:03,19/08/2019,10:36:03,0247 UKT 1601617016 0819/0008275        ,0.00,4700000,18304690257.29,19081900082750000055,
2864,19/08/2019,10:36:40,19/08/2019,10:36:40,0247 UKT 1304618017 0819/0008281        ,0.00,3950000,18308640257.29,19081900082810000014,
2865,19/08/2019,10:36:54,19/08/2019,10:36:54,0247 UKT 1101617019 0819/0012490        ,0.00,3000000,18311640257.29,19081900124900000016,
2866,19/08/2019,10:37:00,19/08/2019,10:37:00,0247 UKT 1201617016 0819/0008219        ,0.00,4000000,18315640257.29,19081900082190000056,
2867,19/08/2019,10:37:34,19/08/2019,10:37:34,0247 UKT 1302617074 0819/0017768        ,0.00,3800000,18319440257.29,19081900177680000021,
2868,19/08/2019,10:38:04,19/08/2019,10:38:04,0247 UKT 1101617085 0819/0007770        ,0.00,5300000,18324740257.29,19081900077700000012,
2869,19/08/2019,10:38:56,19/08/2019,10:38:56,0247 UKT 1601617077 0819/0008219        ,0.00,5400000,18330140257.29,19081900082190000058,
2870,19/08/2019,10:39:23,19/08/2019,10:39:23,0247 UKT 1601618079 0819/0012490        ,0.00,2700000,18332840257.29,19081900124900000018,
2871,19/08/2019,10:39:56,19/08/2019,10:39:56,0247 UKT 1106618063 0819/0006664        ,0.00,5100000,18337940257.29,19081900066640000008,
2872,19/08/2019,10:40:22,19/08/2019,10:40:22,0247 UKT 1106617048 0819/0011965        ,0.00,6400000,18344340257.29,19081900119650000010,
2873,19/08/2019,10:40:32,19/08/2019,10:40:32,0247 UKT 1601617227 0819/0013785        ,0.00,5700000,18350040257.29,19081900137850000036,
2874,19/08/2019,10:41:02,19/08/2019,10:41:02,0247 UKT 1601618046 0819/0012490        ,0.00,3400000,18353440257.29,19081900124900000020,
2875,19/08/2019,10:41:48,19/08/2019,10:41:48,0247 UKT 1603617075 0819/0010941        ,0.00,3200000,18356640257.29,19081900109410000040,
2876,19/08/2019,10:42:36,19/08/2019,10:42:36,0247 UKT 1205618042 0819/0017012        ,0.00,1000000,18357640257.29,19081900170120000035,
2877,19/08/2019,10:43:51,19/08/2019,10:43:51,0247 UKT 1101617103 0819/0012490        ,0.00,6700000,18364340257.29,19081900124900000022,
2878,19/08/2019,10:46:35,19/08/2019,10:46:35,0247 UKT 1209618035 0819/0016437        ,0.00,4500000,18368840257.29,19081900164370000029,
2879,19/08/2019,10:46:55,19/08/2019,10:46:55,0247 UKT 1203618009 0819/0008219        ,0.00,5600000,18374440257.29,19081900082190000060,
2880,19/08/2019,10:48:16,19/08/2019,10:48:16,0247 UKT 1104617057 0819/0007222        ,0.00,3000000,18377440257.29,19081900072220000023,
2881,19/08/2019,10:48:20,19/08/2019,10:48:20,0247 UKT                                ,0.00,4500000,18381940257.29,19081999482010052330,
2882,19/08/2019,10:49:08,19/08/2019,10:49:08,0247 UKT 1201617019 0819/0013436        ,0.00,4700000,18386640257.29,19081900134360000198,
2883,19/08/2019,10:52:26,19/08/2019,10:52:26,0247 UKT 1602617163 0819/0007348        ,0.00,2700000,18389340257.29,19081900073480000026,
2884,19/08/2019,10:52:27,19/08/2019,10:52:27,0247 UKT 1107618027 0819/0013785        ,0.00,3900000,18393240257.29,19081900137850000048,
2885,19/08/2019,10:54:14,19/08/2019,10:54:14,0247 UKT 1107618025 0819/0016439        ,0.00,6400000,18399640257.29,19081900164390000029,
2886,19/08/2019,10:54:19,19/08/2019,10:54:19,0247 UKT 1104617087 0819/0012246        ,0.00,5300000,18404940257.29,19081900122460000030,
2887,19/08/2019,10:54:32,19/08/2019,10:54:32,0247 UKT 1209618014 0819/0008219        ,0.00,1000000,18405940257.29,19081900082190000062,
2888,19/08/2019,10:54:34,19/08/2019,10:54:34,0247 UKT 1602618022 0819/0008186        ,0.00,2700000,18408640257.29,19081900081860000038,
2889,19/08/2019,10:58:38,19/08/2019,10:58:38,0247 UKT 1304618028 0819/0012476        ,0.00,3950000,18412590257.29,19081900124760000020,
2890,19/08/2019,10:58:50,19/08/2019,10:58:50,0247 UKT 1602617076 0819/0011958        ,0.00,3400000,18415990257.29,19081900119580000036,
2891,19/08/2019,10:59:47,19/08/2019,10:59:47,0247 UKT                                ,0.00,6900000,18422890257.29,19081999049010143333,
2892,19/08/2019,11:01:02,19/08/2019,11:01:02,0247 UKT 1207618052 0819/0013788        ,0.00,5900000,18428790257.29,19081900137880000010,
2893,19/08/2019,11:02:27,19/08/2019,11:02:27,0247 UKT 1301618032 0819/0017768        ,0.00,5000000,18433790257.29,19081900177680000023,
2894,19/08/2019,11:04:01,19/08/2019,11:04:01,0247 UKT 1205618081 0819/0012486        ,0.00,3900000,18437690257.29,19081900124860000030,
2895,19/08/2019,11:05:41,19/08/2019,11:05:41,0247 UKT 1204617054 0819/0012245        ,0.00,3900000,18441590257.29,19081900122450000100,
2896,19/08/2019,11:06:11,19/08/2019,11:06:11,0247 UKT 1104617100 0819/0016545        ,0.00,6700000,18448290257.29,19081900165450000090,
2897,19/08/2019,11:06:23,19/08/2019,11:06:23,0247 UKT 1105617010 0819/0013447        ,0.00,5100000,18453390257.29,19081900134470000019,
2898,19/08/2019,11:07:29,19/08/2019,11:07:29,0247 UKT 1206618033 0819/0017789        ,0.00,4500000,18457890257.29,19081900177890000045,
2899,19/08/2019,11:09:57,19/08/2019,11:09:57,0247 UKT 1206618006 0819/0008219        ,0.00,6700000,18464590257.29,19081900082190000064,
2900,19/08/2019,11:10:52,19/08/2019,11:10:52,0247 UKT 1107618129 0819/0012489        ,0.00,5100000,18469690257.29,19081900124890000012,
2901,19/08/2019,11:12:33,19/08/2019,11:12:33,0247 UKT 1102617085 0819/0007770        ,0.00,3000000,18472690257.29,19081900077700000021,
2902,19/08/2019,11:13:16,19/08/2019,11:13:16,0247 UKT 1601617021 0819/0008222        ,0.00,4700000,18477390257.29,19081900082220000031,
2903,19/08/2019,11:15:24,19/08/2019,11:15:24,0247 UKT 1206617029 0819/0012247        ,0.00,5200000,18482590257.29,19081900122470000013,
2904,19/08/2019,11:16:13,19/08/2019,11:16:13,0247 UKT 1107618141 0819/0008264        ,0.00,4500000,18487090257.29,19081900082640000024,
2905,19/08/2019,11:16:37,19/08/2019,11:16:37,0247 UKT 1208618024 0819/0008219        ,0.00,4500000,18491590257.29,19081900082190000066,
2906,19/08/2019,11:16:48,19/08/2019,11:16:48,0247 UKT 1602617178 0819/0016727        ,0.00,500000,18492090257.29,19081900167270000036,
2907,19/08/2019,11:16:57,19/08/2019,11:16:57,0247 UKT 1603618013 0819/0016437        ,0.00,3200000,18495290257.29,19081900164370000052,
2908,19/08/2019,11:17:52,19/08/2019,11:17:52,0247 UKT 1210617052 0819/0009558        ,0.00,4600000,18499890257.29,19081900095580000096,
2909,19/08/2019,11:19:18,19/08/2019,11:19:18,0247 UKT                                ,0.00,6100000,18505990257.29,19081999113810297716,
2910,19/08/2019,11:20:31,19/08/2019,11:20:31,0247 UKT 1107617175 0819/0013765        ,0.00,3000000,18508990257.29,19081900137650000028,
2911,19/08/2019,11:22:05,19/08/2019,11:22:05,0247 UKT 1604618009 0819/0018000        ,0.00,6500000,18515490257.29,19081900180000000039,
2912,19/08/2019,11:22:55,19/08/2019,11:22:55,0247 UKT 1601617073 0819/0016544        ,0.00,4000000,18519490257.29,19081900165440000043,
2913,19/08/2019,11:24:28,19/08/2019,11:24:28,0247 UKT 1801618032 0819/0008219        ,0.00,4000000,18523490257.29,19081900082190000068,
2914,19/08/2019,11:24:52,19/08/2019,11:24:52,0247 UKT 1207617040 0819/0007900        ,0.00,6700000,18530190257.29,19081900079000000029,
2915,19/08/2019,11:25:54,19/08/2019,11:25:54,0247 UKT 1107618103 0819/0013069        ,0.00,4500000,18534690257.29,19081900130690000055,
2916,19/08/2019,11:28:12,19/08/2019,11:28:12,0247 UKT 1801617280 0819/0012490        ,0.00,8200000,18542890257.29,19081900124900000025,
2917,19/08/2019,11:28:34,19/08/2019,11:28:34,0247 UKT 1313618008 0819/0008219        ,0.00,5200000,18548090257.29,19081900082190000070,
2918,19/08/2019,11:28:36,19/08/2019,11:28:36,0247 UKT                                ,0.00,5400000,18553490257.29,19081999437010371738,
2919,19/08/2019,11:28:39,19/08/2019,11:28:39,0247 UKT 1106618016 0819/0011952        ,0.00,5100000,18558590257.29,19081900119520000048,
2920,19/08/2019,11:28:43,19/08/2019,11:28:43,0247 UKT 1301617020 0819/0013087        ,0.00,7000000,18565590257.29,19081900130870000063,
2921,19/08/2019,11:30:36,19/08/2019,11:30:36,0247 UKT 1602618052 0819/0016491        ,0.00,4700000,18570290257.29,19081900164910000064,
2922,19/08/2019,11:30:55,19/08/2019,11:30:55,0247 UKT 1203618040 0819/0017768        ,0.00,3700000,18573990257.29,19081900177680000039,
2923,19/08/2019,11:31:04,19/08/2019,11:31:04,0247 UKT 1106617078 0819/0007901        ,0.00,5100000,18579090257.29,19081900079010000024,
2924,19/08/2019,11:31:38,19/08/2019,11:31:38,0247 UKT 1206618044 0819/0008220        ,0.00,4500000,18583590257.29,19081900082200000002,
2925,19/08/2019,11:32:14,19/08/2019,11:32:14,0247 UKT 1301617003 0819/0010977        ,0.00,5000000,18588590257.29,19081900109770000010,
2926,19/08/2019,11:32:22,19/08/2019,11:32:22,0247 UKT 1207617023 0819/0011958        ,0.00,5200000,18593790257.29,19081900119580000044,
2927,19/08/2019,11:32:24,19/08/2019,11:32:24,0247 UKT 1107617237 0819/0017768        ,0.00,1000000,18594790257.29,19081900177680000041,
2928,19/08/2019,11:32:37,19/08/2019,11:32:37,0247 UKT 1305617039 0819/0008214        ,0.00,4000000,18598790257.29,19081900082140000019,
2929,19/08/2019,11:36:10,19/08/2019,11:36:10,0247 UKT 1106617010 0819/0018007        ,0.00,3000000,18601790257.29,19081900180070000027,
2930,19/08/2019,11:37:30,19/08/2019,11:37:30,0247 UKT 1209617024 0819/0013470        ,0.00,6700000,18608490257.29,19081900134700000042,
2931,19/08/2019,11:38:54,19/08/2019,11:38:54,0247 UKT 1205618033 0819/0013436        ,0.00,3900000,18612390257.29,19081900134360000208,
2932,19/08/2019,11:41:21,19/08/2019,11:41:21,0247 UKT 1205617006 0819/0017017        ,0.00,5900000,18618290257.29,19081900170170000020,
2933,19/08/2019,11:41:53,19/08/2019,11:41:53,0247 UKT 1207618033 0819/0009764        ,0.00,7400000,18625690257.29,19081900097640000021,
2934,19/08/2019,11:42:28,19/08/2019,11:42:28,0247 UKT 1601617215 0819/0008175        ,0.00,2700000,18628390257.29,19081900081750000027,
2935,19/08/2019,11:42:59,19/08/2019,11:42:59,0247 UKT 1303617061 0819/0016708        ,0.00,6200000,18634590257.29,19081900167080000016,
2936,19/08/2019,11:43:08,19/08/2019,11:43:08,0247 UKT 1603617078 0819/0012245        ,0.00,3200000,18637790257.29,19081900122450000107,
2937,19/08/2019,11:43:42,19/08/2019,11:43:42,0247 UKT 1301618003 0819/0013069        ,0.00,3800000,18641590257.29,19081900130690000081,
2938,19/08/2019,11:46:14,19/08/2019,11:46:14,0247 UKT 1211617028 0819/0008219        ,0.00,3700000,18645290257.29,19081900082190000073,
2939,19/08/2019,11:47:41,19/08/2019,11:47:41,0247 UKT 1103617030 0819/0018009        ,0.00,4000000,18649290257.29,19081900180090000012,
2940,19/08/2019,11:48:15,19/08/2019,11:48:15,0247 UKT 1201618012 0819/0013447        ,0.00,4000000,18653290257.29,19081900134470000033,
2941,19/08/2019,11:48:33,19/08/2019,11:48:33,0247 UKT 1801618130 0819/0011838        ,0.00,8200000,18661490257.29,19081900118380000011,
2942,19/08/2019,11:51:50,19/08/2019,11:51:50,0247 UKT 1211617009 0819/0008219        ,0.00,5600000,18667090257.29,19081900082190000075,
2943,19/08/2019,11:51:51,19/08/2019,11:51:51,0247 UKT 1106617076 0819/0011952        ,0.00,3000000,18670090257.29,19081900119520000053,
2944,19/08/2019,11:52:37,19/08/2019,11:52:37,0247 UKT 1602617170 0819/0016488        ,0.00,2700000,18672790257.29,19081900164880000019,
2945,19/08/2019,11:53:19,19/08/2019,11:53:19,0247 UKT 1203617033 0819/0008219        ,0.00,5600000,18678390257.29,19081900082190000077,
2946,19/08/2019,11:54:35,19/08/2019,11:54:35,0247 UKT 1205618073 0819/0016491        ,0.00,5900000,18684290257.29,19081900164910000071,
2947,19/08/2019,11:54:45,19/08/2019,11:54:45,0247 UKT 1305618019 0819/0008219        ,0.00,4000000,18688290257.29,19081900082190000079,
2948,19/08/2019,11:55:21,19/08/2019,11:55:21,0247 UKT 1307617021 0819/0010758        ,0.00,8000000,18696290257.29,19081900107580000016,
2949,19/08/2019,12:00:36,19/08/2019,12:00:36,0247 UKT 1104618080 0819/0017789        ,0.00,5300000,18701590257.29,19081900177890000056,
2950,19/08/2019,12:01:02,19/08/2019,12:01:02,0247 UKT 1602617191 0819/0008594        ,0.00,3400000,18704990257.29,19081900085940000018,
2951,19/08/2019,12:02:21,19/08/2019,12:02:21,0247 UKT 1303618042 0819/0008281        ,0.00,3950000,18708940257.29,19081900082810000025,
2952,19/08/2019,12:04:37,19/08/2019,12:04:37,0247 UKT 1801617187 0819/0013436        ,0.00,4000000,18712940257.29,19081900134360000225,
2953,19/08/2019,12:04:45,19/08/2019,12:04:45,0247 UKT 1107617048 0819/0017342        ,0.00,5100000,18718040257.29,19081900173420000065,
2954,19/08/2019,12:06:00,19/08/2019,12:06:00,0247 UKT                                ,0.00,4000000,18722040257.29,19081999257020661687,
2955,19/08/2019,12:06:18,19/08/2019,12:06:18,0247 UKT                                ,0.00,4000000,18726040257.29,19081999281010663794,
2956,19/08/2019,12:06:28,19/08/2019,12:06:28,0247 UKT 1602618080 0819/0008572        ,0.00,3400000,18729440257.29,19081900085720000050,
2957,19/08/2019,12:11:16,19/08/2019,12:11:16,0247 UKT 1603617118 0819/0007222        ,0.00,3200000,18732640257.29,19081900072220000040,
2958,19/08/2019,12:12:20,19/08/2019,12:12:20,0247 UKT                                ,0.00,4000000,18736640257.29,19081999410010707391,
2959,19/08/2019,12:19:53,19/08/2019,12:19:53,0247 UKT 1305617040 0819/0011829        ,0.00,4000000,18740640257.29,19081900118290000006,
2960,19/08/2019,12:24:38,19/08/2019,12:24:38,0247 UKT 1604618047 0819/0016629        ,0.00,3200000,18743840257.29,19081900166290000011,
2961,19/08/2019,12:29:59,19/08/2019,12:29:59,0247 UKT                                ,0.00,5600000,18749440257.29,19081999101060836037,
2962,19/08/2019,12:31:08,19/08/2019,12:31:08,0247 UKT 1601617075 0819/0007337        ,0.00,2700000,18752140257.29,19081900073370000079,
2963,19/08/2019,12:33:20,19/08/2019,12:33:20,0247 UKT 1306617004 0819/0006669        ,0.00,6200000,18758340257.29,19081900066690000047,
2964,19/08/2019,12:36:03,19/08/2019,12:36:03,0247 UKT 1105617014 0819/0017002        ,0.00,3900000,18762240257.29,19081900170020000036,
2965,19/08/2019,12:38:36,19/08/2019,12:38:36,0247 UKT 1106618027 0819/0012490        ,0.00,3000000,18765240257.29,19081900124900000031,
2966,19/08/2019,12:41:21,19/08/2019,12:41:21,0247 UKT 1605618031 0819/0016727        ,0.00,6500000,18771740257.29,19081900167270000048,
2967,19/08/2019,12:42:04,19/08/2019,12:42:04,0247 UKT 1603617022 0819/0006664        ,0.00,3200000,18774940257.29,19081900066640000017,
2968,19/08/2019,12:44:17,19/08/2019,12:44:17,0247 UKT 1602617213 0819/0008940        ,0.00,2700000,18777640257.29,19081900089400000084,
2969,19/08/2019,12:48:17,19/08/2019,12:48:17,0247 UKT 1604618060 0819/0007248        ,0.00,6500000,18784140257.29,19081900072480000025,
2970,19/08/2019,12:49:00,19/08/2019,12:49:00,0247 UKT 1604618063 0819/0007248        ,0.00,7600000,18791740257.29,19081900072480000027,
2971,19/08/2019,12:49:28,19/08/2019,12:49:28,0247 UKT 1604618065 0819/0007248        ,0.00,7600000,18799340257.29,19081900072480000029,
2972,19/08/2019,12:49:56,19/08/2019,12:49:56,0247 UKT 1601617195 0819/0007248        ,0.00,1000000,18800340257.29,19081900072480000031,
2973,19/08/2019,12:50:25,19/08/2019,12:50:25,0247 UKT 1601617031 0819/0007248        ,0.00,8000000,18808340257.29,19081900072480000033,
2974,19/08/2019,12:50:49,19/08/2019,12:50:49,0247 UKT 1103618052 0819/0008561        ,0.00,6700000,18815040257.29,19081900085610000028,
2975,19/08/2019,12:50:50,19/08/2019,12:50:50,0247 UKT 1601617196 0819/0007248        ,0.00,8000000,18823040257.29,19081900072480000035,
2976,19/08/2019,12:51:03,19/08/2019,12:51:03,0247 UKT                                ,0.00,5000000,18828040257.29,19081999113810985071,
2977,19/08/2019,12:51:18,19/08/2019,12:51:18,0247 UKT 1604618062 0819/0007248        ,0.00,7600000,18835640257.29,19081900072480000037,
2978,19/08/2019,12:51:44,19/08/2019,12:51:44,0247 UKT 1604618064 0819/0007248        ,0.00,7600000,18843240257.29,19081900072480000039,
2979,19/08/2019,12:52:11,19/08/2019,12:52:11,0247 UKT 1601617194 0819/0007248        ,0.00,8000000,18851240257.29,19081900072480000041,
2980,19/08/2019,12:52:40,19/08/2019,12:52:40,0247 UKT 1604618061 0819/0007248        ,0.00,7600000,18858840257.29,19081900072480000043,
2981,19/08/2019,12:57:40,19/08/2019,12:57:40,0247 UKT 1209617059 0819/0016657        ,0.00,5900000,18864740257.29,19081900166570000073,
2982,19/08/2019,12:57:58,19/08/2019,12:57:58,0247 UKT 1202617031 0819/0016629        ,0.00,3900000,18868640257.29,19081900166290000014,
2983,19/08/2019,13:00:08,19/08/2019,13:00:08,0247 UKT 1102617061 0819/0017995        ,0.00,1000000,18869640257.29,19081900179950000025,
2984,19/08/2019,13:00:51,19/08/2019,13:00:51,0247 UKT 1210618014 0819/0008298        ,0.00,7700000,18877340257.29,19081900082980000023,
2985,19/08/2019,13:01:41,19/08/2019,13:01:41,0247 UKT 1201617030 0819/0005990        ,0.00,1000000,18878340257.29,19081900059900000007,
2986,19/08/2019,13:03:38,19/08/2019,13:03:38,0247 UKT 1210617033 0819/0009551        ,0.00,6900000,18885240257.29,19081900095510000151,
2987,19/08/2019,13:07:23,19/08/2019,13:07:23,0247 UKT 1205617098 0819/0008219        ,0.00,5900000,18891140257.29,19081900082190000081,
2988,19/08/2019,13:09:37,19/08/2019,13:09:37,0247 UKT 1106617038 0819/0008219        ,0.00,5100000,18896240257.29,19081900082190000083,
2989,19/08/2019,13:10:44,19/08/2019,13:10:44,0247 UKT 1801617071 0819/0008219        ,0.00,4000000,18900240257.29,19081900082190000085,
2990,19/08/2019,13:10:56,19/08/2019,13:10:56,0247 UKT 1207617029 0819/0017968        ,0.00,4500000,18904740257.29,19081900179680000038,
2991,19/08/2019,13:11:44,19/08/2019,13:11:44,0247 UKT 1302617015 0819/0008219        ,0.00,3800000,18908540257.29,19081900082190000087,
2992,19/08/2019,13:12:29,19/08/2019,13:12:29,0247 UKT 1107617232 0819/0011541        ,0.00,5100000,18913640257.29,19081900115410000065,
2993,19/08/2019,13:14:23,19/08/2019,13:14:23,0247 UKT 1603617128 0819/0008225        ,0.00,1000000,18914640257.29,19081900082250000088,
2994,19/08/2019,13:16:14,19/08/2019,13:16:14,0247 UKT 1602618072 0819/0016535        ,0.00,4700000,18919340257.29,19081900165350000017,
2995,19/08/2019,13:16:26,19/08/2019,13:16:26,0247 UKT 1211617051 0819/0008219        ,0.00,5000000,18924340257.29,19081900082190000089,
2996,19/08/2019,13:16:44,19/08/2019,13:16:44,0247 UKT 1303618016 0819/0011952        ,0.00,3950000,18928290257.29,19081900119520000062,
2997,19/08/2019,13:17:38,19/08/2019,13:17:38,0247 UKT 1105617054 0819/0012249        ,0.00,1000000,18929290257.29,19081900122490000056,
2998,19/08/2019,13:18:40,19/08/2019,13:18:40,0247 UKT 1602617181 0819/0008214        ,0.00,4700000,18933990257.29,19081900082140000028,
2999,19/08/2019,13:19:07,19/08/2019,13:19:07,0247 UKT 1603618016 0819/0017338        ,0.00,6500000,18940490257.29,19081900173380000034,
3000,19/08/2019,13:19:37,19/08/2019,13:19:37,0247 UKT 1209618043 0819/0016412        ,0.00,5900000,18946390257.29,19081900164120000096,
3001,19/08/2019,13:20:51,19/08/2019,13:20:51,0247 UKT 1107617124 0819/0016488        ,0.00,5100000,18951490257.29,19081900164880000022,
3002,19/08/2019,13:21:53,19/08/2019,13:21:53,0247 UKT 1602617090 0819/0008175        ,0.00,4700000,18956190257.29,19081900081750000037,
3003,19/08/2019,13:21:58,19/08/2019,13:21:58,0247 UKT 1213617016 0819/0016999        ,0.00,500000,18956690257.29,19081900169990000030,
3004,19/08/2019,13:22:21,19/08/2019,13:22:21,0247 UKT                                ,0.00,3800000,18960490257.29,19081999113810203671,
3005,19/08/2019,13:26:08,19/08/2019,13:26:08,0247 UKT 1603617072 0819/0011958        ,0.00,4300000,18964790257.29,19081900119580000062,
3006,19/08/2019,13:26:30,19/08/2019,13:26:30,0247 UKT 1604618059 0819/0010530        ,0.00,7600000,18972390257.29,19081900105300000058,
3007,19/08/2019,13:26:55,19/08/2019,13:26:55,0247 UKT 1209618046 0819/0008219        ,0.00,7100000,18979490257.29,19081900082190000098,
3008,19/08/2019,13:27:34,19/08/2019,13:27:34,0247 UKT 1801618079 0819/0016489        ,0.00,7200000,18986690257.29,19081900164890000027,
3009,19/08/2019,13:28:23,19/08/2019,13:28:23,0247 UKT 1307617017 0819/0008219        ,0.00,5250000,18991940257.29,19081900082190000100,
3010,19/08/2019,13:29:52,19/08/2019,13:29:52,0247 UKT 1801617100 0819/0009627        ,0.00,4000000,18995940257.29,19081900096270000015,
3011,19/08/2019,13:29:59,19/08/2019,13:29:59,0247 UKT 1313617036 0819/0017996        ,0.00,5200000,19001140257.29,19081900179960000068,
3012,19/08/2019,13:31:47,19/08/2019,13:31:47,0247 UKT 1601617198 0819/0009665        ,0.00,1000000,19002140257.29,19081900096650000051,
3013,19/08/2019,13:32:22,19/08/2019,13:32:22,0247 UKT 1210617034 0819/0012486        ,0.00,5500000,19007640257.29,19081900124860000049,
3014,19/08/2019,13:32:24,19/08/2019,13:32:24,0247 UKT 1801617156 0819/0010423        ,0.00,6200000,19013840257.29,19081900104230000054,
3015,19/08/2019,13:32:51,19/08/2019,13:32:51,0247 UKT 1308617040 0819/0010423        ,0.00,4650000,19018490257.29,19081900104230000056,
3016,19/08/2019,13:33:08,19/08/2019,13:33:08,0247 UKT 1207617031 0819/0017744        ,0.00,1000000,19019490257.29,19081900177440000041,
3017,19/08/2019,13:33:49,19/08/2019,13:33:49,0247 UKT 1801617142 0819/0008219        ,0.00,8200000,19027690257.29,19081900082190000102,
3018,19/08/2019,13:34:00,19/08/2019,13:34:00,0247 UKT 1210618040 0819/0016671        ,0.00,4600000,19032290257.29,19081900166710000051,
3019,19/08/2019,13:35:47,19/08/2019,13:35:47,0247 UKT 1106618057 0819/0016711        ,0.00,5100000,19037390257.29,19081900167110000041,
3020,19/08/2019,13:37:23,19/08/2019,13:37:23,0247 UKT                                ,0.00,6200000,19043590257.29,19081999113810319540,
3021,19/08/2019,13:37:28,19/08/2019,13:37:28,0247 UKT 1211617025 0819/0008594        ,0.00,5600000,19049190257.29,19081900085940000035,
3022,19/08/2019,13:38:10,19/08/2019,13:38:10,0247 UKT 1601617124 0819/0018139        ,0.00,4700000,19053890257.29,19081900181390000019,
3023,19/08/2019,13:38:37,19/08/2019,13:38:37,0247 UKT 1801618156 0819/0018004        ,0.00,8200000,19062090257.29,19081900180040000018,
3024,19/08/2019,13:38:38,19/08/2019,13:38:38,0247 UKT 1313618032 0819/0012474        ,0.00,6200000,19068290257.29,19081900124740000078,
3025,19/08/2019,13:39:01,19/08/2019,13:39:01,0247 UKT 1210618019 0819/0008219        ,0.00,4600000,19072890257.29,19081900082190000104,
3026,19/08/2019,13:39:13,19/08/2019,13:39:13,0247 UKT 1308617052 0819/0017989        ,0.00,4150000,19077040257.29,19081900179890000002,
3027,19/08/2019,13:39:18,19/08/2019,13:39:18,0247 UKT 1601617166 0819/0018139        ,0.00,500000,19077540257.29,19081900181390000021,
3028,19/08/2019,13:39:18,19/08/2019,13:39:18,0247 UKT 1204618012 0819/0013056        ,0.00,5900000,19083440257.29,19081900130560000035,
3029,19/08/2019,13:40:16,19/08/2019,13:40:16,0247 UKT 1107617054 0819/0008219        ,0.00,5100000,19088540257.29,19081900082190000106,
3030,19/08/2019,13:41:47,19/08/2019,13:41:47,0247 UKT 1313617017 0819/0017990        ,0.00,6200000,19094740257.29,19081900179900000035,
3031,19/08/2019,13:42:10,19/08/2019,13:42:10,0247 UKT 1605618005 0819/0016993        ,0.00,6500000,19101240257.29,19081900169930000042,
3032,19/08/2019,13:43:48,19/08/2019,13:43:48,0247 UKT 1602618005 0819/0010496        ,0.00,4700000,19105940257.29,19081900104960000141,
3033,19/08/2019,13:44:05,19/08/2019,13:44:05,0247 UKT 1202617045 0819/0008302        ,0.00,3900000,19109840257.29,19081900083020000081,
3034,19/08/2019,13:46:09,19/08/2019,13:46:09,0247 UKT 1210617031 0819/0008220        ,0.00,4600000,19114440257.29,19081900082200000020,
3035,19/08/2019,13:46:15,19/08/2019,13:46:15,0247 UKT 1603617136 0819/0008594        ,0.00,6500000,19120940257.29,19081900085940000037,
3036,19/08/2019,13:46:56,19/08/2019,13:46:56,0247 UKT 1101617027 0819/0016724        ,0.00,3000000,19123940257.29,19081900167240000065,
3037,19/08/2019,13:47:16,19/08/2019,13:47:16,0247 UKT 1105618037 0819/0013799        ,0.00,3900000,19127840257.29,19081900137990000121,
3038,19/08/2019,13:48:15,19/08/2019,13:48:15,0247 UKT 1205618028 0819/0016657        ,0.00,3900000,19131740257.29,19081900166570000079,
3039,19/08/2019,13:48:19,19/08/2019,13:48:19,0247 UKT 1209617069 0819/0016436        ,0.00,6700000,19138440257.29,19081900164360000115,
3040,19/08/2019,13:48:22,19/08/2019,13:48:22,0247 UKT 1107617134 0819/0009627        ,0.00,3900000,19142340257.29,19081900096270000018,
3041,19/08/2019,13:48:52,19/08/2019,13:48:52,0247 UKT 1103617053 0819/0017744        ,0.00,3000000,19145340257.29,19081900177440000046,
3042,19/08/2019,13:49:38,19/08/2019,13:49:38,0247 UKT 1304618012 0819/0008219        ,0.00,3950000,19149290257.29,19081900082190000109,
3043,19/08/2019,13:50:19,19/08/2019,13:50:19,0247 UKT 1601617200 0819/0010978        ,0.00,4700000,19153990257.29,19081900109780000079,
3044,19/08/2019,13:50:38,19/08/2019,13:50:38,0247 UKT 1207618022 0819/0013469        ,0.00,500000,19154490257.29,19081900134690000024,
3045,19/08/2019,13:52:01,19/08/2019,13:52:01,0247 UKT 1208617009 0819/0008219        ,0.00,4500000,19158990257.29,19081900082190000111,
3046,19/08/2019,13:54:01,19/08/2019,13:54:01,0247 UKT 1102617090 0819/0016723        ,0.00,3000000,19161990257.29,19081900167230000011,
3047,19/08/2019,13:54:06,19/08/2019,13:54:06,0247 UKT 1601618083 0819/0008219        ,0.00,4700000,19166690257.29,19081900082190000113,
3048,19/08/2019,13:54:36,19/08/2019,13:54:36,0247 UKT 1105618036 0819/0006168        ,0.00,5100000,19171790257.29,19081900061680000078,
3049,19/08/2019,13:55:12,19/08/2019,13:55:12,0247 UKT                                ,0.00,4650000,19176440257.29,19081999138010457114,
3050,19/08/2019,13:56:19,19/08/2019,13:56:19,0247 UKT 1210618071 0819/0008219        ,0.00,4600000,19181040257.29,19081900082190000115,
3051,19/08/2019,13:56:46,19/08/2019,13:56:46,0247 UKT 1104617029 0819/0007348        ,0.00,3000000,19184040257.29,19081900073480000054,
3052,19/08/2019,13:57:26,19/08/2019,13:57:26,0247 UKT 1105618046 0819/0012245        ,0.00,3000000,19187040257.29,19081900122450000153,
3053,19/08/2019,13:57:27,19/08/2019,13:57:27,0247 UKT 1603618036 0819/0013788        ,0.00,3200000,19190240257.29,19081900137880000023,
3054,19/08/2019,13:57:47,19/08/2019,13:57:47,0247 UKT 1208617030 0819/0012491        ,0.00,4500000,19194740257.29,19081900124910000082,
3055,19/08/2019,13:58:17,19/08/2019,13:58:17,0247 UKT 1208617044 0819/0012491        ,0.00,4500000,19199240257.29,19081900124910000084,
3056,19/08/2019,13:59:08,19/08/2019,13:59:08,0247 UKT 1106618033 0819/0018009        ,0.00,5100000,19204340257.29,19081900180090000023,
3057,19/08/2019,13:59:41,19/08/2019,13:59:41,0247 UKT 1105618056 0819/0016625        ,0.00,5100000,19209440257.29,19081900166250000014,
3058,19/08/2019,14:00:06,19/08/2019,14:00:06,0247 UKT 1201617073 0819/0012245        ,0.00,6000000,19215440257.29,19081900122450000155,
3059,19/08/2019,14:00:49,19/08/2019,14:00:49,0247 UKT 1303617041 0819/0011549        ,0.00,5200000,19220640257.29,19081900115490000016,
3060,19/08/2019,14:01:36,19/08/2019,14:01:36,0247 UKT 1604618023 0819/0008574        ,0.00,1000000,19221640257.29,19081900085740000144,
3061,19/08/2019,14:01:53,19/08/2019,14:01:53,0247 UKT 1302617062 0819/0016660        ,0.00,500000,19222140257.29,19081900166600000077,
3062,19/08/2019,14:01:55,19/08/2019,14:01:55,0247 UKT 1209617012 0819/0008219        ,0.00,4500000,19226640257.29,19081900082190000119,
3063,19/08/2019,14:03:10,19/08/2019,14:03:10,0247 UKT 1203617080 0819/0013442        ,0.00,4300000,19230940257.29,19081900134420000062,
3064,19/08/2019,14:03:11,19/08/2019,14:03:11,0247 UKT 1207618006 0819/0008219        ,0.00,1000000,19231940257.29,19081900082190000121,
3065,19/08/2019,14:04:31,19/08/2019,14:04:31,0247 UKT 1106618012 0819/0010490        ,0.00,5100000,19237040257.29,19081900104900000111,
3066,19/08/2019,14:04:51,19/08/2019,14:04:51,0247 UKT                                ,0.00,6200000,19243240257.29,19081999016700528311,
3067,19/08/2019,14:05:56,19/08/2019,14:05:56,0247 UKT 1605618020 0819/0008219        ,0.00,3200000,19246440257.29,19081900082190000123,
3068,19/08/2019,14:07:31,19/08/2019,14:07:31,0247 UKT 1601617088 0819/0018179        ,0.00,4700000,19251140257.29,19081900181790000048,
3069,19/08/2019,14:07:46,19/08/2019,14:07:46,0247 UKT 1603617068 0819/0007759        ,0.00,6500000,19257640257.29,19081900077590000115,
3070,19/08/2019,14:07:50,19/08/2019,14:07:50,0247 UKT 1304618079 0819/0013062        ,0.00,3950000,19261590257.29,19081900130620000076,
3071,19/08/2019,14:08:55,19/08/2019,14:08:55,0247 UKT 1207617051 0819/0008225        ,0.00,4500000,19266090257.29,19081900082250000101,
3072,19/08/2019,14:09:18,19/08/2019,14:09:18,0247 UKT 1107617204 0819/0016657        ,0.00,5100000,19271190257.29,19081900166570000085,
3073,19/08/2019,14:09:18,19/08/2019,14:09:18,0247 UKT 1101617113 0819/0008219        ,0.00,5300000,19276490257.29,19081900082190000125,
3074,19/08/2019,14:09:52,19/08/2019,14:09:52,0247 UKT 1103617097 0819/0018015        ,0.00,5300000,19281790257.29,19081900180150000042,
3075,19/08/2019,14:10:19,19/08/2019,14:10:19,0247 UKT 1308617033 0819/0016700        ,0.00,4150000,19285940257.29,19081900167000000050,
3076,19/08/2019,14:11:16,19/08/2019,14:11:16,0247 UKT 1208617047 0819/0008219        ,0.00,6700000,19292640257.29,19081900082190000127,
3077,19/08/2019,14:13:11,19/08/2019,14:13:11,0247 UKT 1208617034 0819/0008219        ,0.00,4500000,19297140257.29,19081900082190000129,
3078,19/08/2019,14:13:58,19/08/2019,14:13:58,0247 UKT 1201618040 0819/0011952        ,0.00,1000000,19298140257.29,19081900119520000079,
3079,19/08/2019,14:14:12,19/08/2019,14:14:12,0247 UKT 1107618114 0819/0016542        ,0.00,5100000,19303240257.29,19081900165420000065,
3080,19/08/2019,14:15:10,19/08/2019,14:15:10,0247 UKT 1302618016 0819/0008219        ,0.00,3800000,19307040257.29,19081900082190000131,
3081,19/08/2019,14:19:17,19/08/2019,14:19:17,0247 UKT 1203618020 0819/0008219        ,0.00,4300000,19311340257.29,19081900082190000133,
3082,19/08/2019,14:21:14,19/08/2019,14:21:14,0247 UKT 1601617083 0819/0017773        ,0.00,4700000,19316040257.29,19081900177730000101,
3083,19/08/2019,14:21:19,19/08/2019,14:21:19,0247 UKT 1203618006 0819/0008219        ,0.00,1000000,19317040257.29,19081900082190000135,
3084,19/08/2019,14:21:30,19/08/2019,14:21:30,0247 UKT 1801617296 0819/0010971        ,0.00,6200000,19323240257.29,19081900109710000037,
3085,19/08/2019,14:22:53,19/08/2019,14:22:53,0247 UKT 1203618037 0819/0008219        ,0.00,3700000,19326940257.29,19081900082190000137,
3086,19/08/2019,14:24:58,19/08/2019,14:24:58,0247 UKT 1203618029 0819/0008219        ,0.00,5600000,19332540257.29,19081900082190000139,
3087,19/08/2019,14:25:05,19/08/2019,14:25:05,0247 UKT 1101618064 0819/0017016        ,0.00,4700000,19337240257.29,19081900170160000169,
3088,19/08/2019,14:28:01,19/08/2019,14:28:01,0247 UKT 1304618077 0819/0016657        ,0.00,7500000,19344740257.29,19081900166570000087,
3089,19/08/2019,14:28:20,19/08/2019,14:28:20,0247 UKT 1102618050 0819/0012491        ,0.00,3000000,19347740257.29,19081900124910000090,
3090,19/08/2019,14:28:43,19/08/2019,14:28:43,0247 UKT 1304618048 0819/0011549        ,0.00,4500000,19352240257.29,19081900115490000020,
3091,19/08/2019,14:29:41,19/08/2019,14:29:41,0247 UKT 1602617146 0819/0007466        ,0.00,2700000,19354940257.29,19081900074660000071,
3092,19/08/2019,14:30:21,19/08/2019,14:30:21,0247 UKT 1601617113 0819/0008552        ,0.00,4700000,19359640257.29,19081900085520000145,
3093,19/08/2019,14:31:13,19/08/2019,14:31:13,0247 UKT 1103618036 0819/0007248        ,0.00,5300000,19364940257.29,19081900072480000063,
3094,19/08/2019,14:31:25,19/08/2019,14:31:25,0247 UKT 1101617109 0819/0008219        ,0.00,5300000,19370240257.29,19081900082190000143,
3095,19/08/2019,14:31:55,19/08/2019,14:31:55,0247 UKT 1106618018 0819/0016438        ,0.00,1000000,19371240257.29,19081900164380000050,
3096,19/08/2019,14:33:16,19/08/2019,14:33:16,0247 UKT 1205618038 0819/0008219        ,0.00,7800000,19379040257.29,19081900082190000145,
3097,19/08/2019,14:35:40,19/08/2019,14:35:40,0247 UKT 1314617014 0819/0016488        ,0.00,500000,19379540257.29,19081900164880000024,
3098,19/08/2019,14:44:27,19/08/2019,14:44:27,0247 UKT 1107617217 0819/0012491        ,0.00,1000000,19380540257.29,19081900124910000093,
3099,19/08/2019,14:44:41,19/08/2019,14:44:41,0247 UKT 1601617049 0819/0017474        ,0.00,5700000,19386240257.29,19081900174740000047,
3100,19/08/2019,14:45:19,19/08/2019,14:45:19,0247 UKT 1602618044 0819/0013823        ,0.00,4700000,19390940257.29,19081900138230000152,
3101,19/08/2019,14:50:43,19/08/2019,14:50:43,0247 UKT 1101617061 0819/0013080        ,0.00,4000000,19394940257.29,19081900130800000097,
3102,19/08/2019,14:52:17,19/08/2019,14:52:17,0247 UKT 1303618054 0819/0007348        ,0.00,6200000,19401140257.29,19081900073480000064,
3103,19/08/2019,14:53:18,19/08/2019,14:53:18,0247 UKT 1602617034 0819/0007751        ,0.00,2700000,19403840257.29,19081900077510000076,
3104,19/08/2019,14:54:10,19/08/2019,14:54:10,0247 UKT 1603617137 0819/0012247        ,0.00,6500000,19410340257.29,19081900122470000054,
3105,19/08/2019,14:57:00,19/08/2019,14:57:00,0247 UKT 1201617037 0819/0016488        ,0.00,4000000,19414340257.29,19081900164880000031,
3106,19/08/2019,14:57:12,19/08/2019,14:57:12,0247 UKT 1105617049 0819/0016441        ,0.00,5100000,19419440257.29,19081900164410000057,
3107,19/08/2019,15:01:25,19/08/2019,15:01:25,0247 UKT 1102618048 0819/0017974        ,0.00,3000000,19422440257.29,19081900179740000172,
3108,19/08/2019,15:01:32,19/08/2019,15:01:32,0247 UKT 1207618026 0819/0011958        ,0.00,500000,19422940257.29,19081900119580000104,
3109,19/08/2019,15:01:49,19/08/2019,15:01:49,0247 UKT                                ,0.00,4000000,19426940257.29,19081999200010950016,
3110,19/08/2019,15:06:16,19/08/2019,15:06:16,0247 UKT 1302617020 0819/0008219        ,0.00,3800000,19430740257.29,19081900082190000147,
3111,19/08/2019,15:09:48,19/08/2019,15:09:48,0247 UKT 1303618067 0819/0008219        ,0.00,3950000,19434690257.29,19081900082190000149,
3112,19/08/2019,15:12:40,19/08/2019,15:12:40,0247 UKT 1201618015 0819/0017993        ,0.00,4000000,19438690257.29,19081900179930000193,
3113,19/08/2019,15:14:13,19/08/2019,15:14:13,0247 UKT 1207618050 0819/0008219        ,0.00,4500000,19443190257.29,19081900082190000151,
3114,19/08/2019,15:15:57,19/08/2019,15:15:57,0247 UKT 1605618013 0819/0008219        ,0.00,6500000,19449690257.29,19081900082190000153,
3115,19/08/2019,15:29:22,19/08/2019,15:29:22,0247 UKT 1601617084 0819/0007357        ,0.00,3400000,19453090257.29,19081900073570000051,
3116,19/08/2019,16:20:22,19/08/2019,16:20:22,0247 UKT                                ,0.00,5300000,19458390257.29,19081999678010521871,
3117,19/08/2019,16:31:13,19/08/2019,16:31:13,0247 UKT                                ,0.00,6900000,19465290257.29,19081999544010605689,
3118,19/08/2019,16:31:14,19/08/2019,16:31:14,0247 UKT                                ,0.00,6000000,19471290257.29,19081999459010605729,
3119,19/08/2019,17:26:54,19/08/2019,17:26:54,0247 UKT                                ,0.00,6200000,19477490257.29,19081999189010022023,
3120,19/08/2019,19:02:18,19/08/2019,19:02:18,0247 UKT                                ,0.00,5800000,19483290257.29,19081999528010680891,
3121,19/08/2019,19:27:25,19/08/2019,19:27:25,0247 UKT                                ,0.00,4150000,19487440257.29,19081999293010864591,
3122,19/08/2019,20:45:39,19/08/2019,20:45:39,0247 UKT                                ,0.00,6250000,19493690257.29,19081999107710382900,
3123,19/08/2019,20:58:41,19/08/2019,20:58:41,0247 UKT                                ,0.00,6500000,19500190257.29,19081999016810456475,
3124,19/08/2019,21:30:04,19/08/2019,21:30:04,0247 UKT                                ,0.00,3900000,19504090257.29,19081999043140619715,
3125,20/08/2019,07:15:28,20/08/2019,07:15:28,0247 UKT                                ,0.00,6700000,19510790257.29,19082099100110685609,
3126,20/08/2019,07:50:45,20/08/2019,07:50:45,0247 UKT 1105618027 0819/0017778        ,0.00,5100000,19515890257.29,19082000177780000004,
3127,20/08/2019,07:59:35,20/08/2019,07:59:35,0247 UKT 1207617041 0819/0017991        ,0.00,4500000,19520390257.29,19082000179910000002,
3128,20/08/2019,08:04:38,20/08/2019,08:04:38,0247 UKT 1105617034 0819/0008219        ,0.00,5100000,19525490257.29,19082000082190000002,
3129,20/08/2019,08:06:17,20/08/2019,08:06:17,0247 UKT 1207617016 0819/0009665        ,0.00,4500000,19529990257.29,19082000096650000002,
3130,20/08/2019,08:11:39,20/08/2019,08:11:39,0247 UKT 1207618038 0819/0007348        ,0.00,7400000,19537390257.29,19082000073480000002,
3131,20/08/2019,08:15:19,20/08/2019,08:15:19,0247 UKT 1107618109 0819/0010684        ,0.00,5100000,19542490257.29,19082000106840000003,
3132,20/08/2019,08:16:30,20/08/2019,08:16:30,0247 UKT 1307618008 0819/0016628        ,0.00,4150000,19546640257.29,19082000166280000007,
3133,20/08/2019,08:23:16,20/08/2019,08:23:16,0247 UKT 1203617009 0819/0008219        ,0.00,5600000,19552240257.29,19082000082190000004,
3134,20/08/2019,08:26:31,20/08/2019,08:26:31,0247 UKT 1307617006 0819/0007366        ,0.00,8000000,19560240257.29,19082000073660000004,
3135,20/08/2019,08:27:28,20/08/2019,08:27:28,0247 UKT 1104618048 0819/0010413        ,0.00,3000000,19563240257.29,19082000104130000003,
3136,20/08/2019,08:37:09,20/08/2019,08:37:09,0247 UKT 1104618040 0819/0008219        ,0.00,3000000,19566240257.29,19082000082190000008,
3137,20/08/2019,08:37:11,20/08/2019,08:37:11,0247 UKT                                ,0.00,3000000,19569240257.29,19082099240010216505,
3138,20/08/2019,08:37:34,20/08/2019,08:37:34,0247 UKT 1304618019 0819/0017972        ,0.00,3950000,19573190257.29,19082000179720000070,
3139,20/08/2019,08:40:20,20/08/2019,08:40:20,0247 UKT 1106618059 0819/0008219        ,0.00,6400000,19579590257.29,19082000082190000010,
3140,20/08/2019,08:44:44,20/08/2019,08:44:44,0247 UKT 1801617278 0819/0012490        ,0.00,7200000,19586790257.29,19082000124900000014,
3141,20/08/2019,08:44:50,20/08/2019,08:44:50,0247 UKT                                ,0.00,6400000,19593190257.29,19082099297010272166,
3142,20/08/2019,08:47:01,20/08/2019,08:47:01,0247 UKT 1601617012 0819/0016612        ,0.00,4700000,19597890257.29,19082000166120000010,
3143,20/08/2019,08:49:20,20/08/2019,08:49:20,0247 UKT 1205617064 0819/0008219        ,0.00,3900000,19601790257.29,19082000082190000012,
3144,20/08/2019,08:49:34,20/08/2019,08:49:34,0247 UKT 1106617072 0819/0018233        ,0.00,3000000,19604790257.29,19082000182330000013,
3145,20/08/2019,08:51:03,20/08/2019,08:51:03,0247 UKT 1801618037 0819/0008957        ,0.00,8200000,19612990257.29,19082000089570000002,
3146,20/08/2019,08:51:43,20/08/2019,08:51:43,0247 UKT 1106617016 0819/0016550        ,0.00,5100000,19618090257.29,19082000165500000009,
3147,20/08/2019,08:52:58,20/08/2019,08:52:58,0247 UKT 1102617097 0819/0016629        ,0.00,500000,19618590257.29,19082000166290000006,
3148,20/08/2019,08:54:35,20/08/2019,08:54:35,0247 UKT 1102617026 0819/0008219        ,0.00,3000000,19621590257.29,19082000082190000016,
3149,20/08/2019,09:05:46,20/08/2019,09:05:46,0247 UKT 1208617022 0819/0013175        ,0.00,4500000,19626090257.29,19082000131750000018,
3150,20/08/2019,09:11:02,20/08/2019,09:11:02,0247 UKT 1107617196 0819/0008555        ,0.00,1000000,19627090257.29,19082000085550000002,
3151,20/08/2019,09:12:05,20/08/2019,09:12:05,0247 UKT 1203617037 0819/0008219        ,0.00,3700000,19630790257.29,19082000082190000027,
3152,20/08/2019,09:13:21,20/08/2019,09:13:21,0247 UKT 1206618043 0819/0007348        ,0.00,6700000,19637490257.29,19082000073480000018,
3153,20/08/2019,09:15:27,20/08/2019,09:15:27,0247 UKT 1604618046 0819/0009746        ,0.00,3200000,19640690257.29,19082000097460000006,
3154,20/08/2019,09:21:55,20/08/2019,09:21:55,0247 UKT 1103617057 0819/0013065        ,0.00,4700000,19645390257.29,19082000130650000006,
3155,20/08/2019,09:22:04,20/08/2019,09:22:04,0247 UKT 1603617123 0819/0017768        ,0.00,6500000,19651890257.29,19082000177680000006,
3156,20/08/2019,09:23:37,20/08/2019,09:23:37,0247 UKT 1204617052 0819/0013469        ,0.00,3900000,19655790257.29,19082000134690000007,
3157,20/08/2019,09:25:46,20/08/2019,09:25:46,0247 UKT 1801618127 0819/0016491        ,0.00,8200000,19663990257.29,19082000164910000018,
3158,20/08/2019,09:28:18,20/08/2019,09:28:18,0247 UKT 1801618054 0819/0008219        ,0.00,6200000,19670190257.29,19082000082190000029,
3159,20/08/2019,09:29:31,20/08/2019,09:29:31,0247 UKT 1205617062 0819/0008296        ,0.00,5200000,19675390257.29,19082000082960000010,
3160,20/08/2019,09:30:35,20/08/2019,09:30:35,0247 UKT 1601617208 0819/0017978        ,0.00,3400000,19678790257.29,19082000179780000036,
3161,20/08/2019,09:34:07,20/08/2019,09:34:07,0247 UKT 1106618080 0819/0017789        ,0.00,1000000,19679790257.29,19082000177890000020,
3162,20/08/2019,09:35:57,20/08/2019,09:35:57,0247 UKT 1302618020 0819/0010423        ,0.00,3800000,19683590257.29,19082000104230000002,
3163,20/08/2019,09:36:28,20/08/2019,09:36:28,0247 UKT 1207618020 0819/0011932        ,0.00,500000,19684090257.29,19082000119320000005,
3164,20/08/2019,09:36:34,20/08/2019,09:36:34,0247 UKT 1107617189 0819/0016700        ,0.00,5100000,19689190257.29,19082000167000000045,
3165,20/08/2019,09:37:25,20/08/2019,09:37:25,0247 UKT 1106618054 0819/0010443        ,0.00,5800000,19694990257.29,19082000104430000044,
3166,20/08/2019,09:40:00,20/08/2019,09:40:00,0247 UKT 1303617058 0819/0007348        ,0.00,6200000,19701190257.29,19082000073480000022,
3167,20/08/2019,09:41:42,20/08/2019,09:41:42,0247 UKT 1210617030 0819/0008264        ,0.00,4600000,19705790257.29,19082000082640000008,
3168,20/08/2019,09:42:02,20/08/2019,09:42:02,0247 UKT 1103617096 0819/0011549        ,0.00,4000000,19709790257.29,19082000115490000002,
3169,20/08/2019,09:42:49,20/08/2019,09:42:49,0247 UKT 1308617054 0819/0007337        ,0.00,8000000,19717790257.29,19082000073370000016,
3170,20/08/2019,09:44:51,20/08/2019,09:44:51,0247 UKT 1211618027 0819/0008219        ,0.00,3700000,19721490257.29,19082000082190000035,
3171,20/08/2019,09:47:10,20/08/2019,09:47:10,0247 UKT 1201617070 0819/0017974        ,0.00,4700000,19726190257.29,19082000179740000036,
3172,20/08/2019,09:48:24,20/08/2019,09:48:24,0247 UKT 1601617044 0819/0017980        ,0.00,2700000,19728890257.29,19082000179800000049,
3173,20/08/2019,09:48:42,20/08/2019,09:48:42,0247 UKT 1204617006 0819/0012239        ,0.00,3900000,19732790257.29,19082000122390000007,
3174,20/08/2019,09:49:42,20/08/2019,09:49:42,0247 UKT 1101617100 0819/0007357        ,0.00,6000000,19738790257.29,19082000073570000015,
3175,20/08/2019,09:49:49,20/08/2019,09:49:49,0247 UKT 1107617127 0819/0010941        ,0.00,1000000,19739790257.29,19082000109410000017,
3176,20/08/2019,09:49:52,20/08/2019,09:49:52,0247 UKT 1303617042 0819/0017985        ,0.00,6200000,19745990257.29,19082000179850000010,
3177,20/08/2019,09:50:44,20/08/2019,09:50:44,0247 UKT 1801618096 0819/0013482        ,0.00,4000000,19749990257.29,19082000134820000010,
3178,20/08/2019,09:51:12,20/08/2019,09:51:12,0247 UKT 1304618040 0819/0017768        ,0.00,3950000,19753940257.29,19082000177680000008,
3179,20/08/2019,09:52:07,20/08/2019,09:52:07,0247 UKT 1303618047 0819/0010443        ,0.00,3950000,19757890257.29,19082000104430000048,
3180,20/08/2019,09:52:11,20/08/2019,09:52:11,0247 UKT 1303618012 0819/0012475        ,0.00,3950000,19761840257.29,19082000124750000037,
3181,20/08/2019,09:54:08,20/08/2019,09:54:08,0247 UKT 1603618005 0819/0008219        ,0.00,4300000,19766140257.29,19082000082190000037,
3182,20/08/2019,09:56:09,20/08/2019,09:56:09,0247 UKT 1211618023 0819/0017963        ,0.00,5900000,19772040257.29,19082000179630000015,
3183,20/08/2019,09:58:50,20/08/2019,09:58:50,0247 UKT 1801617021 0819/0017963        ,0.00,4000000,19776040257.29,19082000179630000017,
3184,20/08/2019,09:59:00,20/08/2019,09:59:00,0247 UKT 1302617049 0819/0010469        ,0.00,3800000,19779840257.29,19082000104690000039,
3185,20/08/2019,09:59:12,20/08/2019,09:59:12,0247 UKT 1209617011 0819/0016648        ,0.00,4500000,19784340257.29,19082000166480000030,
3186,20/08/2019,09:59:49,20/08/2019,09:59:49,0247 UKT 1801617143 0819/0010413        ,0.00,4000000,19788340257.29,19082000104130000009,
3187,20/08/2019,10:00:36,20/08/2019,10:00:36,0247 UKT 1207618043 0819/0017989        ,0.00,6700000,19795040257.29,19082000179890000025,
3188,20/08/2019,10:01:43,20/08/2019,10:01:43,0247 UKT 1308618063 0819/0008219        ,0.00,1000000,19796040257.29,19082000082190000039,
3189,20/08/2019,10:02:09,20/08/2019,10:02:09,0247 UKT 1301618008 0819/0011547        ,0.00,4300000,19800340257.29,19082000115470000067,
3190,20/08/2019,10:03:33,20/08/2019,10:03:33,0247 UKT 1103617089 0819/0008219        ,0.00,5300000,19805640257.29,19082000082190000041,
3191,20/08/2019,10:03:44,20/08/2019,10:03:44,0247 UKT 1107617174 0819/0007248        ,0.00,3900000,19809540257.29,19082000072480000006,
3192,20/08/2019,10:04:26,20/08/2019,10:04:26,0247 UKT 1207618016 0819/0008186        ,0.00,4500000,19814040257.29,19082000081860000034,
3193,20/08/2019,10:06:05,20/08/2019,10:06:05,0247 UKT 1205617089 0819/0016488        ,0.00,5200000,19819240257.29,19082000164880000008,
3194,20/08/2019,10:06:32,20/08/2019,10:06:32,0247 UKT 1209618032 0819/0016525        ,0.00,6700000,19825940257.29,19082000165250000015,
3195,20/08/2019,10:07:01,20/08/2019,10:07:01,0247 UKT 1305618022 0819/0007754        ,0.00,4000000,19829940257.29,19082000077540000081,
3196,20/08/2019,10:07:03,20/08/2019,10:07:03,0247 UKT 1603618012 0819/0008219        ,0.00,1000000,19830940257.29,19082000082190000043,
3197,20/08/2019,10:07:43,20/08/2019,10:07:43,0247 UKT 1304617034 0819/0016487        ,0.00,6200000,19837140257.29,19082000164870000032,
3198,20/08/2019,10:09:33,20/08/2019,10:09:33,0247 UKT 1213618006 0819/0016619        ,0.00,5900000,19843040257.29,19082000166190000004,
3199,20/08/2019,10:12:19,20/08/2019,10:12:19,0247 UKT 1602617053 0819/0009627        ,0.00,4000000,19847040257.29,19082000096270000008,
3200,20/08/2019,10:13:13,20/08/2019,10:13:13,0247 UKT 1105617030 0819/0012249        ,0.00,3000000,19850040257.29,19082000122490000034,
3201,20/08/2019,10:13:15,20/08/2019,10:13:15,0247 UKT 1204617018 0819/0016659        ,0.00,5900000,19855940257.29,19082000166590000028,
3202,20/08/2019,10:13:38,20/08/2019,10:13:38,0247 UKT 1603617104 0819/0013794        ,0.00,4300000,19860240257.29,19082000137940000090,
3203,20/08/2019,10:14:33,20/08/2019,10:14:33,0247 UKT 1604618030 0819/0013503        ,0.00,3200000,19863440257.29,19082000135030000027,
3204,20/08/2019,10:14:52,20/08/2019,10:14:52,0247 UKT 1604618015 0819/0007466        ,0.00,500000,19863940257.29,19082000074660000018,
3205,20/08/2019,10:16:03,20/08/2019,10:16:03,0247 UKT 1209617044 0819/0011549        ,0.00,4500000,19868440257.29,19082000115490000008,
3206,20/08/2019,10:17:44,20/08/2019,10:17:44,0247 UKT 1605618008 0819/0013470        ,0.00,6500000,19874940257.29,19082000134700000026,
3207,20/08/2019,10:17:47,20/08/2019,10:17:47,0247 UKT 1103617026 0819/0008214        ,0.00,6000000,19880940257.29,19082000082140000009,
3208,20/08/2019,10:17:48,20/08/2019,10:17:48,0247 UKT 1601617210 0819/0008594        ,0.00,1000000,19881940257.29,19082000085940000019,
3209,20/08/2019,10:18:11,20/08/2019,10:18:11,0247 UKT 1313617035 0819/0016539        ,0.00,4500000,19886440257.29,19082000165390000009,
3210,20/08/2019,10:18:28,20/08/2019,10:18:28,0247 UKT 1203617049 0819/0008219        ,0.00,3700000,19890140257.29,19082000082190000047,
3211,20/08/2019,10:19:22,20/08/2019,10:19:22,0247 UKT 1602618058 0819/0012245        ,0.00,3400000,19893540257.29,19082000122450000026,
3212,20/08/2019,10:19:24,20/08/2019,10:19:24,0247 UKT 1601617098 0819/0008594        ,0.00,2700000,19896240257.29,19082000085940000021,
3213,20/08/2019,10:21:17,20/08/2019,10:21:17,0247 UKT 1314618023 0819/0012476        ,0.00,7300000,19903540257.29,19082000124760000016,
3214,20/08/2019,10:21:56,20/08/2019,10:21:56,0247 UKT 1105618014 0819/0018024        ,0.00,5100000,19908640257.29,19082000180240000014,
3215,20/08/2019,10:26:14,20/08/2019,10:26:14,0247 UKT 1603618010 0819/0012936        ,0.00,500000,19909140257.29,19082000129360000010,
3216,20/08/2019,10:29:57,20/08/2019,10:29:57,0247 UKT 1102618074 0819/0016491        ,0.00,3900000,19913040257.29,19082000164910000041,
3217,20/08/2019,10:30:59,20/08/2019,10:30:59,0247 UKT 1107617119 0819/0013823        ,0.00,3000000,19916040257.29,19082000138230000034,
3218,20/08/2019,10:31:42,20/08/2019,10:31:42,0247 UKT 1202617011 0819/0008588        ,0.00,5900000,19921940257.29,19082000085880000028,
3219,20/08/2019,10:31:44,20/08/2019,10:31:44,0247 UKT 1801617261 0819/0018233        ,0.00,4000000,19925940257.29,19082000182330000036,
3220,20/08/2019,10:32:44,20/08/2019,10:32:44,0247 UKT 1303617014 0819/0018357        ,0.00,3950000,19929890257.29,19082000183570000016,
3221,20/08/2019,10:33:24,20/08/2019,10:33:24,0247 UKT 1602617019 0819/0008594        ,0.00,1000000,19930890257.29,19082000085940000023,
3222,20/08/2019,10:33:53,20/08/2019,10:33:53,0247 UKT 1801617150 0819/0008550        ,0.00,8200000,19939090257.29,19082000085500000036,
3223,20/08/2019,10:34:56,20/08/2019,10:34:56,0247 UKT 1602617134 0819/0008594        ,0.00,3400000,19942490257.29,19082000085940000025,
3224,20/08/2019,10:35:09,20/08/2019,10:35:09,0247 UKT 1103618030 0819/0018000        ,0.00,4000000,19946490257.29,19082000180000000003,
3225,20/08/2019,10:35:34,20/08/2019,10:35:34,0247 UKT 1106617023 0819/0016615        ,0.00,5800000,19952290257.29,19082000166150000006,
3226,20/08/2019,10:41:14,20/08/2019,10:41:14,0247 UKT 1301618006 0819/0008219        ,0.00,5000000,19957290257.29,19082000082190000052,
3227,20/08/2019,10:45:18,20/08/2019,10:45:18,0247 UKT 1601617093 0819/0008237        ,0.00,2700000,19959990257.29,19082000082370000004,
3228,20/08/2019,10:45:40,20/08/2019,10:45:40,0247 UKT 1104617019 0819/0008219        ,0.00,1000000,19960990257.29,19082000082190000054,
3229,20/08/2019,10:46:28,20/08/2019,10:46:28,0247 UKT 1314617028 0819/0016528        ,0.00,4000000,19964990257.29,19082000165280000057,
3230,20/08/2019,10:48:47,20/08/2019,10:48:47,0247 UKT                                ,0.00,4000000,19968990257.29,19082099226020219462,
3231,20/08/2019,10:49:46,20/08/2019,10:49:46,0247 UKT 1101617090 0819/0018000        ,0.00,4000000,19972990257.29,19082000180000000005,
3232,20/08/2019,10:49:48,20/08/2019,10:49:48,0247 UKT 1605618004 0819/0013077        ,0.00,3200000,19976190257.29,19082000130770000010,
3233,20/08/2019,10:54:55,20/08/2019,10:54:55,0247 UKT 1102617048 0819/0008219        ,0.00,3000000,19979190257.29,19082000082190000062,
3234,20/08/2019,10:55:31,20/08/2019,10:55:31,0247 UKT 1103617099 0819/0016491        ,0.00,4000000,19983190257.29,19082000164910000050,
3235,20/08/2019,10:55:42,20/08/2019,10:55:42,0247 UKT 1602617177 0819/0017016        ,0.00,1000000,19984190257.29,19082000170160000069,
3236,20/08/2019,10:55:48,20/08/2019,10:55:48,0247 UKT 1602618019 0819/0011830        ,0.00,4700000,19988890257.29,19082000118300000040,
3237,20/08/2019,10:56:29,20/08/2019,10:56:29,0247 UKT                                ,0.00,4600000,19993490257.29,19082099205010279339,
3238,20/08/2019,10:56:48,20/08/2019,10:56:48,0247 UKT 1601617167 0819/0008219        ,0.00,1000000,19994490257.29,19082000082190000064,
3239,20/08/2019,10:57:24,20/08/2019,10:57:24,0247 UKT 1801618132 0819/0017000        ,0.00,8200000,20002690257.29,19082000170000000069,
3240,20/08/2019,10:58:09,20/08/2019,10:58:09,0247 UKT 1205617018 0819/0016661        ,0.00,5200000,20007890257.29,19082000166610000102,
3241,20/08/2019,11:00:37,20/08/2019,11:00:37,0247 UKT 1101617093 0819/0016679        ,0.00,3000000,20010890257.29,19082000166790000021,
3242,20/08/2019,11:01:25,20/08/2019,11:01:25,0247 UKT 1107617179 0819/0007900        ,0.00,5100000,20015990257.29,19082000079000000037,
3243,20/08/2019,11:03:06,20/08/2019,11:03:06,0247 UKT                                ,0.00,9300000,20025290257.29,19082099016830329145,
3244,20/08/2019,11:03:40,20/08/2019,11:03:40,0247 UKT 1204617026 0819/0008219        ,0.00,3900000,20029190257.29,19082000082190000066,
3245,20/08/2019,11:04:19,20/08/2019,11:04:19,0247 UKT 1104617091 0819/0013052        ,0.00,4000000,20033190257.29,19082000130520000083,
3246,20/08/2019,11:05:12,20/08/2019,11:05:12,0247 UKT 1801617271 0819/0011829        ,0.00,6200000,20039390257.29,19082000118290000034,
3247,20/08/2019,11:07:36,20/08/2019,11:07:36,0247 UKT 1203617035 0819/0013788        ,0.00,5900000,20045290257.29,19082000137880000008,
3248,20/08/2019,11:07:55,20/08/2019,11:07:55,0247 UKT 1107618093 0819/0007901        ,0.00,3000000,20048290257.29,19082000079010000033,
3249,20/08/2019,11:08:04,20/08/2019,11:08:04,0247 UKT 1106617073 0819/0011978        ,0.00,5800000,20054090257.29,19082000119780000123,
3250,20/08/2019,11:08:43,20/08/2019,11:08:43,0247 UKT 1106618065 0819/0013507        ,0.00,5100000,20059190257.29,19082000135070000019,
3251,20/08/2019,11:08:54,20/08/2019,11:08:54,0247 UKT 1205617045 0819/0008177        ,0.00,3900000,20063090257.29,19082000081770000065,
3252,20/08/2019,11:08:56,20/08/2019,11:08:56,0247 UKT 1204617004 0819/0008219        ,0.00,3900000,20066990257.29,19082000082190000068,
3253,20/08/2019,11:09:15,20/08/2019,11:09:15,0247 UKT 1306617017 0819/0008244        ,0.00,1000000,20067990257.29,19082000082440000008,
3254,20/08/2019,11:10:12,20/08/2019,11:10:12,0247 UKT 1201617069 0819/0007758        ,0.00,4000000,20071990257.29,19082000077580000014,
3255,20/08/2019,11:11:36,20/08/2019,11:11:36,0247 UKT 1210618060 0819/0007367        ,0.00,6900000,20078890257.29,19082000073670000016,
3256,20/08/2019,11:12:26,20/08/2019,11:12:26,0247 UKT 1105617056 0819/0008219        ,0.00,5100000,20083990257.29,19082000082190000070,
3257,20/08/2019,11:13:29,20/08/2019,11:13:29,0247 UKT 1103618018 0819/0013066        ,0.00,5300000,20089290257.29,19082000130660000005,
3258,20/08/2019,11:14:33,20/08/2019,11:14:33,0247 UKT 1208617051 0819/0016990        ,0.00,4500000,20093790257.29,19082000169900000040,
3259,20/08/2019,11:14:38,20/08/2019,11:14:38,0247 UKT 1103617015 0819/0013452        ,0.00,4000000,20097790257.29,19082000134520000035,
3260,20/08/2019,11:15:53,20/08/2019,11:15:53,0247 UKT 1102618081 0819/0007346        ,0.00,5800000,20103590257.29,19082000073460000037,
3261,20/08/2019,11:16:04,20/08/2019,11:16:04,0247 UKT 1209618030 0819/0017009        ,0.00,6700000,20110290257.29,19082000170090000054,
3262,20/08/2019,11:16:17,20/08/2019,11:16:17,0247 UKT 1202617030 0819/0013788        ,0.00,4500000,20114790257.29,19082000137880000012,
3263,20/08/2019,11:16:39,20/08/2019,11:16:39,0247 UKT 1101618029 0819/0017974        ,0.00,5300000,20120090257.29,19082000179740000059,
3264,20/08/2019,11:17:20,20/08/2019,11:17:20,0247 UKT 1205618084 0819/0016491        ,0.00,3900000,20123990257.29,19082000164910000054,
3265,20/08/2019,11:18:26,20/08/2019,11:18:26,0247 UKT                                ,0.00,8200000,20132190257.29,19082099487010447746,
3266,20/08/2019,11:19:03,20/08/2019,11:19:03,0247 UKT 1107617111 0819/0017359        ,0.00,3000000,20135190257.29,19082000173590000032,
3267,20/08/2019,11:19:14,20/08/2019,11:19:14,0247 UKT 1105617036 0819/0008219        ,0.00,1000000,20136190257.29,19082000082190000072,
3268,20/08/2019,11:21:23,20/08/2019,11:21:23,0247 UKT 1602618068 0819/0016710        ,0.00,4700000,20140890257.29,19082000167100000086,
3269,20/08/2019,11:21:37,20/08/2019,11:21:37,0247 UKT 1107617273 0819/0009593        ,0.00,5100000,20145990257.29,19082000095930000018,
3270,20/08/2019,11:21:54,20/08/2019,11:21:54,0247 UKT 1304618070 0819/0016439        ,0.00,6200000,20152190257.29,19082000164390000027,
3271,20/08/2019,11:22:44,20/08/2019,11:22:44,0247 UKT 1206617042 0819/0008219        ,0.00,5900000,20158090257.29,19082000082190000074,
3272,20/08/2019,11:23:02,20/08/2019,11:23:02,0247 UKT                                ,0.00,1000000,20159090257.29,19082099113810483835,
3273,20/08/2019,11:23:17,20/08/2019,11:23:17,0247 UKT 1203617043 0819/0017783        ,0.00,3700000,20162790257.29,19082000177830000068,
3274,20/08/2019,11:27:49,20/08/2019,11:27:49,0247 UKT 1307618025 0819/0018013        ,0.00,6250000,20169040257.29,19082000180130000016,
3275,20/08/2019,11:29:13,20/08/2019,11:29:13,0247 UKT 1603617138 0819/0008164        ,0.00,3200000,20172240257.29,19082000081640000040,
3276,20/08/2019,11:31:32,20/08/2019,11:31:32,0247 UKT 1602617165 0819/0008594        ,0.00,3400000,20175640257.29,19082000085940000027,
3277,20/08/2019,11:31:47,20/08/2019,11:31:47,0247 UKT 1203617040 0819/0018183        ,0.00,5600000,20181240257.29,19082000181830000053,
3278,20/08/2019,11:33:45,20/08/2019,11:33:45,0247 UKT 1314617026 0819/0017009        ,0.00,7300000,20188540257.29,19082000170090000057,
3279,20/08/2019,11:34:35,20/08/2019,11:34:35,0247 UKT 1103617112 0819/0013057        ,0.00,4000000,20192540257.29,19082000130570000039,
3280,20/08/2019,11:34:54,20/08/2019,11:34:54,0247 UKT 1104617084 0819/0013439        ,0.00,3000000,20195540257.29,19082000134390000026,
3281,20/08/2019,11:35:52,20/08/2019,11:35:52,0247 UKT 1107617224 0819/0010932        ,0.00,5100000,20200640257.29,19082000109320000025,
3282,20/08/2019,11:36:07,20/08/2019,11:36:07,0247 UKT 1301617011 0819/0008214        ,0.00,4300000,20204940257.29,19082000082140000018,
3283,20/08/2019,11:36:55,20/08/2019,11:36:55,0247 UKT 1314617029 0819/0016549        ,0.00,4000000,20208940257.29,19082000165490000037,
3284,20/08/2019,11:37:13,20/08/2019,11:37:13,0247 UKT 1105617018 0819/0010443        ,0.00,6400000,20215340257.29,19082000104430000077,
3285,20/08/2019,11:37:53,20/08/2019,11:37:53,0247 UKT 1210617013 0819/0006069        ,0.00,1000000,20216340257.29,19082000060690000062,
3286,20/08/2019,11:39:29,20/08/2019,11:39:29,0247 UKT 1605618007 0819/0008219        ,0.00,3200000,20219540257.29,19082000082190000076,
3287,20/08/2019,11:42:04,20/08/2019,11:42:04,0247 UKT 1208617032 0819/0017789        ,0.00,5200000,20224740257.29,19082000177890000058,
3288,20/08/2019,11:42:52,20/08/2019,11:42:52,0247 UKT 1205617024 0819/0017017        ,0.00,500000,20225240257.29,19082000170170000032,
3289,20/08/2019,11:44:53,20/08/2019,11:44:53,0247 UKT 1103618076 0819/0016705        ,0.00,5300000,20230540257.29,19082000167050000013,
3290,20/08/2019,11:46:03,20/08/2019,11:46:03,0247 UKT 1603617086 0819/0016545        ,0.00,3200000,20233740257.29,19082000165450000079,
3291,20/08/2019,11:47:46,20/08/2019,11:47:46,0247 UKT 1207618036 0819/0010482        ,0.00,1000000,20234740257.29,19082000104820000048,
3292,20/08/2019,11:54:34,20/08/2019,11:54:34,0247 UKT 1601617043 0819/0013824        ,0.00,2700000,20237440257.29,19082000138240000150,
3293,20/08/2019,12:02:22,20/08/2019,12:02:22,0247 UKT 1105617068 0819/0008219        ,0.00,500000,20237940257.29,19082000082190000080,
3294,20/08/2019,12:18:56,20/08/2019,12:18:56,0247 UKT 1601617032 0819/0008275        ,0.00,5700000,20243640257.29,19082000082750000004,
3295,20/08/2019,12:22:28,20/08/2019,12:22:28,0247 UKT 1206617015 0819/0006645        ,0.00,4500000,20248140257.29,19082000066450000077,
3296,20/08/2019,12:27:06,20/08/2019,12:27:06,0247 UKT                                ,0.00,7100000,20255240257.29,19082099279010963627,
3297,20/08/2019,12:27:29,20/08/2019,12:27:29,0247 UKT 1601617141 0819/0008951        ,0.00,1000000,20256240257.29,19082000089510000046,
3298,20/08/2019,12:28:59,20/08/2019,12:28:59,0247 UKT                                ,0.00,5600000,20261840257.29,19082099144010977452,
3299,20/08/2019,12:29:03,20/08/2019,12:29:03,0247 UKT 1105618042 0819/0017987        ,0.00,5100000,20266940257.29,19082000179870000025,
3300,20/08/2019,12:29:25,20/08/2019,12:29:25,0247 UKT                                ,0.00,5300000,20272240257.29,19082099330010980851,
3301,20/08/2019,12:34:30,20/08/2019,12:34:30,0247 UKT 1602618020 0819/0017995        ,0.00,4000000,20276240257.29,19082000179950000029,
3302,20/08/2019,12:38:37,20/08/2019,12:38:37,0247 UKT 1602617099 0819/0018018        ,0.00,4700000,20280940257.29,19082000180180000044,
3303,20/08/2019,12:39:49,20/08/2019,12:39:49,0247 UKT 1301618038 0819/0013467        ,0.00,6000000,20286940257.29,19082000134670000013,
3304,20/08/2019,12:44:48,20/08/2019,12:44:48,0247 UKT 1602617096 0819/0010977        ,0.00,5700000,20292640257.29,19082000109770000024,
3305,20/08/2019,12:47:14,20/08/2019,12:47:14,0247 UKT 1106617013 0819/0006828        ,0.00,6400000,20299040257.29,19082000068280000039,
3306,20/08/2019,12:48:03,20/08/2019,12:48:03,0247 UKT 1603617142 0819/0016490        ,0.00,3200000,20302240257.29,19082000164900000030,
3307,20/08/2019,12:50:56,20/08/2019,12:50:56,0247 UKT 1801618166 0819/0017002        ,0.00,1000000,20303240257.29,19082000170020000015,
3308,20/08/2019,12:54:33,20/08/2019,12:54:33,0247 UKT                                ,0.00,7300000,20310540257.29,19082099614010163679,
3309,20/08/2019,12:54:58,20/08/2019,12:54:58,0247 UKT 1314617016 0819/0010443        ,0.00,4000000,20314540257.29,19082000104430000085,
3310,20/08/2019,12:56:22,20/08/2019,12:56:22,0247 UKT 1305618023 0819/0010443        ,0.00,4500000,20319040257.29,19082000104430000087,
3311,20/08/2019,12:56:50,20/08/2019,12:56:50,0247 UKT 1209617014 0819/0012489        ,0.00,6700000,20325740257.29,19082000124890000024,
3312,20/08/2019,12:58:04,20/08/2019,12:58:04,0247 UKT                                ,0.00,4000000,20329740257.29,19082099169020188707,
3313,20/08/2019,12:59:10,20/08/2019,12:59:10,0247 UKT 1103617016 0819/0010960        ,0.00,6700000,20336440257.29,19082000109600000069,
3314,20/08/2019,13:02:21,20/08/2019,13:02:21,0247 UKT 1204617019 0819/0011965        ,0.00,3900000,20340340257.29,19082000119650000052,
3315,20/08/2019,13:03:26,20/08/2019,13:03:26,0247 UKT 1603617145 0819/0012245        ,0.00,6500000,20346840257.29,19082000122450000041,
3316,20/08/2019,13:07:48,20/08/2019,13:07:48,0247 UKT 1206618007 0819/0008219        ,0.00,4500000,20351340257.29,19082000082190000083,
3317,20/08/2019,13:09:09,20/08/2019,13:09:09,0247 UKT 1601618017 0819/0013470        ,0.00,2700000,20354040257.29,19082000134700000047,
3318,20/08/2019,13:09:46,20/08/2019,13:09:46,0247 UKT 1205618062 0819/0010423        ,0.00,3900000,20357940257.29,19082000104230000055,
3319,20/08/2019,13:10:27,20/08/2019,13:10:27,0247 UKT 1205618075 0819/0008219        ,0.00,5900000,20363840257.29,19082000082190000085,
3320,20/08/2019,13:11:54,20/08/2019,13:11:54,0247 UKT 1107617129 0819/0010931        ,0.00,5100000,20368940257.29,19082000109310000104,
3321,20/08/2019,13:12:03,20/08/2019,13:12:03,0247 UKT 1205618105 0819/0008219        ,0.00,3900000,20372840257.29,19082000082190000087,
3322,20/08/2019,13:12:23,20/08/2019,13:12:23,0247 UKT 1105618068 0819/0016614        ,0.00,3900000,20376740257.29,19082000166140000022,
3323,20/08/2019,13:13:36,20/08/2019,13:13:36,0247 UKT 1101618065 0819/0008219        ,0.00,5300000,20382040257.29,19082000082190000089,
3324,20/08/2019,13:14:25,20/08/2019,13:14:25,0247 UKT 1106618024 0819/0016661        ,0.00,5100000,20387140257.29,19082000166610000130,
3325,20/08/2019,13:15:24,20/08/2019,13:15:24,0247 UKT 1302618031 0819/0008219        ,0.00,6000000,20393140257.29,19082000082190000091,
3326,20/08/2019,13:15:31,20/08/2019,13:15:31,0247 UKT 1801617137 0819/0011952        ,0.00,1000000,20394140257.29,19082000119520000052,
3327,20/08/2019,13:15:53,20/08/2019,13:15:53,0247 UKT 1104617048 0819/0017008        ,0.00,3000000,20397140257.29,19082000170080000066,
3328,20/08/2019,13:16:20,20/08/2019,13:16:20,0247 UKT 1302617075 0819/0008219        ,0.00,3800000,20400940257.29,19082000082190000093,
3329,20/08/2019,13:16:58,20/08/2019,13:16:58,0247 UKT 1102617050 0819/0016661        ,0.00,4500000,20405440257.29,19082000166610000132,
3330,20/08/2019,13:17:44,20/08/2019,13:17:44,0247 UKT 1203618011 0819/0008219        ,0.00,3700000,20409140257.29,19082000082190000095,
3331,20/08/2019,13:18:57,20/08/2019,13:18:57,0247 UKT 1107618024 0819/0006645        ,0.00,3000000,20412140257.29,19082000066450000085,
3332,20/08/2019,13:18:59,20/08/2019,13:18:59,0247 UKT 1304618051 0819/0017987        ,0.00,3950000,20416090257.29,19082000179870000029,
3333,20/08/2019,13:19:22,20/08/2019,13:19:22,0247 UKT 1207617062 0819/0008219        ,0.00,4500000,20420590257.29,19082000082190000097,
3334,20/08/2019,13:21:13,20/08/2019,13:21:13,0247 UKT 1103618033 0819/0008220        ,0.00,5300000,20425890257.29,19082000082200000014,
3335,20/08/2019,13:22:54,20/08/2019,13:22:54,0247 UKT 1207617046 0819/0008219        ,0.00,1000000,20426890257.29,19082000082190000099,
3336,20/08/2019,13:26:32,20/08/2019,13:26:32,0247 UKT 1211618036 0819/0008219        ,0.00,5600000,20432490257.29,19082000082190000101,
3337,20/08/2019,13:27:07,20/08/2019,13:27:07,0247 UKT 1101617060 0819/0010935        ,0.00,6000000,20438490257.29,19082000109350000063,
3338,20/08/2019,13:28:10,20/08/2019,13:28:10,0247 UKT 1601617035 0819/0017991        ,0.00,500000,20438990257.29,19082000179910000020,
3339,20/08/2019,13:28:37,20/08/2019,13:28:37,0247 UKT 1104617094 0819/0008219        ,0.00,5300000,20444290257.29,19082000082190000103,
3340,20/08/2019,13:30:41,20/08/2019,13:30:41,0247 UKT 1104618077 0819/0008219        ,0.00,4700000,20448990257.29,19082000082190000105,
3341,20/08/2019,13:31:50,20/08/2019,13:31:50,0247 UKT 1106618047 0819/0013436        ,0.00,5800000,20454790257.29,19082000134360000096,
3342,20/08/2019,13:33:15,20/08/2019,13:33:15,0247 UKT 1204617056 0819/0008219        ,0.00,3900000,20458690257.29,19082000082190000108,
3343,20/08/2019,13:33:53,20/08/2019,13:33:53,0247 UKT 1103618071 0819/0011932        ,0.00,5300000,20463990257.29,19082000119320000030,
3344,20/08/2019,13:35:26,20/08/2019,13:35:26,0247 UKT 1103618071 0819/0011932        ,0.00,5300000,20469290257.29,19082000119320000032,
3345,20/08/2019,13:36:19,20/08/2019,13:36:19,0247 UKT 1203618038 0819/0008219        ,0.00,3700000,20472990257.29,19082000082190000110,
3346,20/08/2019,13:37:56,20/08/2019,13:37:56,0247 UKT 1104618043 0819/0016708        ,0.00,4000000,20476990257.29,19082000167080000077,
3347,20/08/2019,13:38:27,20/08/2019,13:38:27,0247 UKT 1601617101 0819/0016631        ,0.00,1000000,20477990257.29,19082000166310000041,
3348,20/08/2019,13:39:35,20/08/2019,13:39:35,0247 UKT 1603617132 0819/0012490        ,0.00,5400000,20483390257.29,19082000124900000047,
3349,20/08/2019,13:39:52,20/08/2019,13:39:52,0247 UKT 1601617013 0819/0016487        ,0.00,4700000,20488090257.29,19082000164870000117,
3350,20/08/2019,13:41:35,20/08/2019,13:41:35,0247 UKT 1604618017 0819/0008219        ,0.00,500000,20488590257.29,19082000082190000112,
3351,20/08/2019,13:43:07,20/08/2019,13:43:07,0247 UKT 1302617059 0819/0016991        ,0.00,4300000,20492890257.29,19082000169910000023,
3352,20/08/2019,13:43:43,20/08/2019,13:43:43,0247 UKT 1601618069 0819/0016612        ,0.00,4700000,20497590257.29,19082000166120000080,
3353,20/08/2019,13:44:14,20/08/2019,13:44:14,0247 UKT 1301617021 0819/0013823        ,0.00,3800000,20501390257.29,19082000138230000089,
3354,20/08/2019,13:44:17,20/08/2019,13:44:17,0247 UKT 1603617080 0819/0008219        ,0.00,3200000,20504590257.29,19082000082190000114,
3355,20/08/2019,13:46:34,20/08/2019,13:46:34,0247 UKT 1103617113 0819/0012245        ,0.00,3000000,20507590257.29,19082000122450000195,
3356,20/08/2019,13:47:01,20/08/2019,13:47:01,0247 UKT 1602617167 0819/0016489        ,0.00,3400000,20510990257.29,19082000164890000018,
3357,20/08/2019,13:47:04,20/08/2019,13:47:04,0247 UKT 1104618007 0819/0008188        ,0.00,3000000,20513990257.29,19082000081880000084,
3358,20/08/2019,13:47:30,20/08/2019,13:47:30,0247 UKT 1205618046 0819/0010413        ,0.00,3900000,20517890257.29,19082000104130000036,
3359,20/08/2019,13:48:47,20/08/2019,13:48:47,0247 UKT 1302618005 0819/0017004        ,0.00,3800000,20521690257.29,19082000170040000022,
3360,20/08/2019,13:48:48,20/08/2019,13:48:48,0247 UKT 1603617124 0819/0016690        ,0.00,3200000,20524890257.29,19082000166900000105,
3361,20/08/2019,13:49:08,20/08/2019,13:49:08,0247 UKT 1305617027 0819/0016588        ,0.00,4000000,20528890257.29,19082000165880000029,
3362,20/08/2019,13:49:24,20/08/2019,13:49:24,0247 UKT 1313618037 0819/0008219        ,0.00,4000000,20532890257.29,19082000082190000116,
3363,20/08/2019,13:49:38,20/08/2019,13:49:38,0247 UKT 1602617129 0819/0008561        ,0.00,4700000,20537590257.29,19082000085610000037,
3364,20/08/2019,13:50:22,20/08/2019,13:50:22,0247 UKT 1107617192 0819/0012479        ,0.00,3000000,20540590257.29,19082000124790000008,
3365,20/08/2019,13:51:51,20/08/2019,13:51:51,0247 UKT 1304617014 0819/0009574        ,0.00,7500000,20548090257.29,19082000095740000095,
3366,20/08/2019,13:52:06,20/08/2019,13:52:06,0247 UKT 1601618095 0819/0012490        ,0.00,1000000,20549090257.29,19082000124900000049,
3367,20/08/2019,13:52:25,20/08/2019,13:52:25,0247 UKT 1307618026 0819/0017972        ,0.00,4150000,20553240257.29,19082000179720000179,
3368,20/08/2019,13:52:28,20/08/2019,13:52:28,0247 UKT 1107618162 0819/0013453        ,0.00,5100000,20558340257.29,19082000134530000016,
3369,20/08/2019,13:52:41,20/08/2019,13:52:41,0247 UKT                                ,0.00,6200000,20564540257.29,19082099113810578236,
3370,20/08/2019,13:53:10,20/08/2019,13:53:10,0247 UKT 1201618059 0819/0008219        ,0.00,4000000,20568540257.29,19082000082190000118,
3371,20/08/2019,13:53:38,20/08/2019,13:53:38,0247 UKT                                ,0.00,4000000,20572540257.29,19082099113810584643,
3372,20/08/2019,13:54:40,20/08/2019,13:54:40,0247 UKT 1211617056 0819/0008219        ,0.00,3700000,20576240257.29,19082000082190000120,
3373,20/08/2019,13:55:30,20/08/2019,13:55:30,0247 UKT 1602618056 0819/0012937        ,0.00,3400000,20579640257.29,19082000129370000005,
3374,20/08/2019,13:55:39,20/08/2019,13:55:39,0247 UKT 1302618051 0819/0010960        ,0.00,3800000,20583440257.29,19082000109600000091,
3375,20/08/2019,13:56:51,20/08/2019,13:56:51,0247 UKT 1601618047 0819/0016688        ,0.00,4700000,20588140257.29,19082000166880000090,
3376,20/08/2019,13:56:54,20/08/2019,13:56:54,0247 UKT 1210618036 0819/0008219        ,0.00,6900000,20595040257.29,19082000082190000122,
3377,20/08/2019,13:56:55,20/08/2019,13:56:55,0247 UKT 1603617151 0819/0012239        ,0.00,3200000,20598240257.29,19082000122390000028,
3378,20/08/2019,13:57:45,20/08/2019,13:57:45,0247 UKT 1204618004 0819/0011547        ,0.00,6400000,20604640257.29,19082000115470000156,
3379,20/08/2019,13:59:08,20/08/2019,13:59:08,0247 UKT 1203618028 0819/0016991        ,0.00,3700000,20608340257.29,19082000169910000027,
3380,20/08/2019,14:02:04,20/08/2019,14:02:04,0247 UKT 1302617060 0819/0016490        ,0.00,6000000,20614340257.29,19082000164900000066,
3381,20/08/2019,14:02:11,20/08/2019,14:02:11,0247 UKT 1201617056 0819/0010956        ,0.00,6000000,20620340257.29,19082000109560000177,
3382,20/08/2019,14:03:37,20/08/2019,14:03:37,0247 UKT 1601618082 0819/0008219        ,0.00,3400000,20623740257.29,19082000082190000124,
3383,20/08/2019,14:05:11,20/08/2019,14:05:11,0247 UKT 1602618075 0819/0008219        ,0.00,1000000,20624740257.29,19082000082190000126,
3384,20/08/2019,14:06:53,20/08/2019,14:06:53,0247 UKT 1210618033 0819/0008219        ,0.00,4600000,20629340257.29,19082000082190000128,
3385,20/08/2019,14:07:14,20/08/2019,14:07:14,0247 UKT 1601618081 0819/0016710        ,0.00,2700000,20632040257.29,19082000167100000153,
3386,20/08/2019,14:10:19,20/08/2019,14:10:19,0247 UKT 1106617077 0819/0012936        ,0.00,5100000,20637140257.29,19082000129360000050,
3387,20/08/2019,14:10:57,20/08/2019,14:10:57,0247 UKT 1105617045 0819/0013823        ,0.00,3000000,20640140257.29,19082000138230000093,
3388,20/08/2019,14:12:13,20/08/2019,14:12:13,0247 UKT 1103618065 0819/lintang chandra,0.00,3000000,20643140257.29,19082000181400000085,
3389,20/08/2019,14:12:25,20/08/2019,14:12:25,0247 UKT 1604618052 0819/0016588        ,0.00,6500000,20649640257.29,19082000165880000033,
3390,20/08/2019,14:12:45,20/08/2019,14:12:45,0247 UKT 1101618066 0819/0013082        ,0.00,3000000,20652640257.29,19082000130820000123,
3391,20/08/2019,14:12:51,20/08/2019,14:12:51,0247 UKT 1603617043 0819/0007222        ,0.00,7600000,20660240257.29,19082000072220000045,
3392,20/08/2019,14:12:55,20/08/2019,14:12:55,0247 UKT 1103617104 0819/0011830        ,0.00,3000000,20663240257.29,19082000118300000084,
3393,20/08/2019,14:14:33,20/08/2019,14:14:33,0247 UKT 1103617093 0819/0016488        ,0.00,5300000,20668540257.29,19082000164880000026,
3394,20/08/2019,14:17:36,20/08/2019,14:17:36,0247 UKT 1301617076 0819/0008225        ,0.00,3800000,20672340257.29,19082000082250000046,
3395,20/08/2019,14:18:01,20/08/2019,14:18:01,0247 UKT 1103618020 0819/0013072        ,0.00,1000000,20673340257.29,19082000130720000056,
3396,20/08/2019,14:19:46,20/08/2019,14:19:46,0247 UKT 1601618030 0819/0008219        ,0.00,4000000,20677340257.29,19082000082190000130,
3397,20/08/2019,14:21:26,20/08/2019,14:21:26,0247 UKT 1605618041 0819/0017966        ,0.00,4300000,20681640257.29,19082000179660000033,
3398,20/08/2019,14:21:44,20/08/2019,14:21:44,0247 UKT 1308617051 0819/0008219        ,0.00,4150000,20685790257.29,19082000082190000132,
3399,20/08/2019,14:22:37,20/08/2019,14:22:37,0247 UKT 1603618032 0819/0007901        ,0.00,6500000,20692290257.29,19082000079010000047,
3400,20/08/2019,14:22:56,20/08/2019,14:22:56,0247 UKT 1207618005 0819/0017009        ,0.00,4500000,20696790257.29,19082000170090000080,
3401,20/08/2019,14:23:22,20/08/2019,14:23:22,0247 UKT 1101617094 0819/0008219        ,0.00,5300000,20702090257.29,19082000082190000134,
3402,20/08/2019,14:24:27,20/08/2019,14:24:27,0247 UKT 1303617036 0819/0010956        ,0.00,3950000,20706040257.29,19082000109560000188,
3403,20/08/2019,14:24:35,20/08/2019,14:24:35,0247 UKT 1102617101 0819/0008219        ,0.00,1000000,20707040257.29,19082000082190000136,
3404,20/08/2019,14:25:44,20/08/2019,14:25:44,0247 UKT 1101617099 0819/0017983        ,0.00,4000000,20711040257.29,19082000179830000114,
3405,20/08/2019,14:27:18,20/08/2019,14:27:18,0247 UKT 1313618012 0819/0018000        ,0.00,4000000,20715040257.29,19082000180000000018,
3406,20/08/2019,14:30:59,20/08/2019,14:30:59,0247 UKT 1210617051 0819/0013765        ,0.00,4600000,20719640257.29,19082000137650000045,
3407,20/08/2019,14:31:11,20/08/2019,14:31:11,0247 UKT 1107617064 0819/0007901        ,0.00,3000000,20722640257.29,19082000079010000049,
3408,20/08/2019,14:31:29,20/08/2019,14:31:29,0247 UKT                                ,0.00,8800000,20731440257.29,19082099054010854085,
3409,20/08/2019,14:31:39,20/08/2019,14:31:39,0247 UKT 1601618100 0819/0013076        ,0.00,4700000,20736140257.29,19082000130760000031,
3410,20/08/2019,14:33:17,20/08/2019,14:33:17,0247 UKT 1103618079 0819/0008219        ,0.00,5300000,20741440257.29,19082000082190000142,
3411,20/08/2019,14:34:15,20/08/2019,14:34:15,0247 UKT 1305617028 0819/0017771        ,0.00,4500000,20745940257.29,19082000177710000119,
3412,20/08/2019,14:35:07,20/08/2019,14:35:07,0247 UKT 1209618009 0819/0008219        ,0.00,7100000,20753040257.29,19082000082190000144,
3413,20/08/2019,14:35:09,20/08/2019,14:35:09,0247 UKT 1302617040 0819/0011547        ,0.00,3800000,20756840257.29,19082000115470000177,
3414,20/08/2019,14:35:46,20/08/2019,14:35:46,0247 UKT 1304617041 0819/0016486        ,0.00,500000,20757340257.29,19082000164860000173,
3415,20/08/2019,14:35:52,20/08/2019,14:35:52,0247 UKT 1103617058 0819/0017756        ,0.00,3000000,20760340257.29,19082000177560000099,
3416,20/08/2019,14:37:07,20/08/2019,14:37:07,0247 UKT 1307618035 0819/0008219        ,0.00,4150000,20764490257.29,19082000082190000147,
3417,20/08/2019,14:39:10,20/08/2019,14:39:10,0247 UKT 1211617042 0819/0008219        ,0.00,4300000,20768790257.29,19082000082190000149,
3418,20/08/2019,14:39:40,20/08/2019,14:39:40,0247 UKT 1602617035 0819/0008594        ,0.00,4000000,20772790257.29,19082000085940000038,
3419,20/08/2019,14:40:35,20/08/2019,14:40:35,0247 UKT 1601617144 0819/0016629        ,0.00,3400000,20776190257.29,19082000166290000030,
3420,20/08/2019,14:41:19,20/08/2019,14:41:19,0247 UKT 1101617095 0819/0017789        ,0.00,3000000,20779190257.29,19082000177890000080,
3421,20/08/2019,14:43:17,20/08/2019,14:43:17,0247 UKT 1603618002 0819/0008219        ,0.00,5400000,20784590257.29,19082000082190000153,
3422,20/08/2019,14:43:30,20/08/2019,14:43:30,0247 UKT 1203617064 0819/0016614        ,0.00,5900000,20790490257.29,19082000166140000040,
3423,20/08/2019,14:44:04,20/08/2019,14:44:04,0247 UKT 1106617020 0819/0013452        ,0.00,5100000,20795590257.29,19082000134520000046,
3424,20/08/2019,14:46:42,20/08/2019,14:46:42,0247 UKT 1303617080 0819/0008555        ,0.00,6200000,20801790257.29,19082000085550000009,
3425,20/08/2019,14:47:44,20/08/2019,14:47:44,0247 UKT 1107618133 0819/0010462        ,0.00,5100000,20806890257.29,19082000104620000048,
3426,20/08/2019,14:48:26,20/08/2019,14:48:26,0247 UKT 1601617192 0819/0013049        ,0.00,4700000,20811590257.29,19082000130490000061,
3427,20/08/2019,14:48:59,20/08/2019,14:48:59,0247 UKT 1103618067 0819/0016708        ,0.00,3000000,20814590257.29,19082000167080000091,
3428,20/08/2019,14:48:59,20/08/2019,14:48:59,0247 UKT 1603618038 0819/0012479        ,0.00,6500000,20821090257.29,19082000124790000010,
3429,20/08/2019,14:50:46,20/08/2019,14:50:46,0247 UKT 1201617006 0819/0008219        ,0.00,6700000,20827790257.29,19082000082190000157,
3430,20/08/2019,14:51:28,20/08/2019,14:51:28,0247 UKT 1603617135 0819/0011817        ,0.00,3200000,20830990257.29,19082000118170000093,
3431,20/08/2019,14:54:12,20/08/2019,14:54:12,0247 UKT 1313617024 0819/0007248        ,0.00,4000000,20834990257.29,19082000072480000249,
3432,20/08/2019,14:56:56,20/08/2019,14:56:56,0247 UKT 1107617249 0819/0017470        ,0.00,4500000,20839490257.29,19082000174700000088,
3433,20/08/2019,15:03:07,20/08/2019,15:03:07,0247 UKT 1801618169 0819/0008555        ,0.00,4000000,20843490257.29,19082000085550000011,
3434,20/08/2019,15:13:08,20/08/2019,15:13:08,0247 UKT 1206618058 0819/0008219        ,0.00,6700000,20850190257.29,19082000082190000162,
3435,20/08/2019,15:14:58,20/08/2019,15:14:58,0247 UKT 1304618014 0819/0008219        ,0.00,6200000,20856390257.29,19082000082190000164,
3436,20/08/2019,15:25:27,20/08/2019,15:25:27,0247 UKT 1601617048 0819/0008594        ,0.00,5700000,20862090257.29,19082000085940000044,
3437,20/08/2019,15:26:43,20/08/2019,15:26:43,0247 UKT 1601617143 0819/0017004        ,0.00,1000000,20863090257.29,19082000170040000035,
3438,20/08/2019,15:29:50,20/08/2019,15:29:50,0247 UKT 1308617010 0819/0016658        ,0.00,6250000,20869340257.29,19082000166580000026,
3439,20/08/2019,15:34:32,20/08/2019,15:34:32,0247 UKT                                ,0.00,5100000,20874440257.29,19082099525010305029,
3440,20/08/2019,17:04:00,20/08/2019,17:04:00,0247 UKT                                ,0.00,4300000,20878740257.29,19082099113810987901,
3441,20/08/2019,17:27:54,20/08/2019,17:27:54,0247 UKT                                ,0.00,6200000,20884940257.29,19082099288010168531,
3442,20/08/2019,17:34:36,20/08/2019,17:34:36,0247 UKT                                ,0.00,500000,20885440257.29,19082099113810218202,
3443,20/08/2019,17:41:54,20/08/2019,17:41:54,0247 UKT                                ,0.00,500000,20885940257.29,19082099047090272418,
3444,20/08/2019,17:51:51,20/08/2019,17:51:51,0247 UKT                                ,0.00,6700000,20892640257.29,19082099137020343253,
3445,20/08/2019,18:21:05,20/08/2019,18:21:05,0247 UKT                                ,0.00,7500000,20900140257.29,19082099239010540050,
3446,20/08/2019,18:42:03,20/08/2019,18:42:03,0247 UKT                                ,0.00,3700000,20903840257.29,19082099296020688625,
3447,20/08/2019,20:33:40,20/08/2019,20:33:40,0247 UKT                                ,0.00,6400000,20910240257.29,19082099048030478952,
3448,20/08/2019,20:37:14,20/08/2019,20:37:14,0247 UKT                                ,0.00,5600000,20915840257.29,19082099390010500489,
3449,20/08/2019,20:57:59,20/08/2019,20:57:59,0247 UKT                                ,0.00,7400000,20923240257.29,19082099204020621091,
3450,21/08/2019,08:02:18,21/08/2019,08:02:18,0247 UKT 1602617141 0819/0008594        ,0.00,500000,20923740257.29,19082100085940000002,
3451,21/08/2019,08:10:53,21/08/2019,08:10:53,0247 UKT 1313617034 0819/0017342        ,0.00,4000000,20927740257.29,19082100173420000002,
3452,21/08/2019,08:14:53,21/08/2019,08:14:53,0247 UKT 1103618061 0819/0006168        ,0.00,3000000,20930740257.29,19082100061680000007,
3453,21/08/2019,08:18:56,21/08/2019,08:18:56,0247 UKT 1302617070 0819/0167038        ,0.00,3800000,20934540257.29,19082101670380000003,
3454,21/08/2019,08:22:05,21/08/2019,08:22:05,0247 UKT 1104617071 0819/0008219        ,0.00,5300000,20939840257.29,19082100082190000002,
3455,21/08/2019,08:23:29,21/08/2019,08:23:29,0247 UKT 1106618005 0819/0016487        ,0.00,5800000,20945640257.29,19082100164870000002,
3456,21/08/2019,08:24:17,21/08/2019,08:24:17,0247 UKT 1601617202 0819/0012245        ,0.00,2700000,20948340257.29,19082100122450000003,
3457,21/08/2019,08:25:23,21/08/2019,08:25:23,0247 UKT 1101617096 0819/0011939        ,0.00,3000000,20951340257.29,19082100119390000003,
3458,21/08/2019,08:26:11,21/08/2019,08:26:11,0247 UKT 1201617021 0819/0012245        ,0.00,6000000,20957340257.29,19082100122450000005,
3459,21/08/2019,08:28:02,21/08/2019,08:28:02,0247 UKT 1601617086 0819/0008261        ,0.00,4700000,20962040257.29,19082100082610000024,
3460,21/08/2019,08:29:07,21/08/2019,08:29:07,0247 UKT 1106617046 0819/0008219        ,0.00,3000000,20965040257.29,19082100082190000005,
3461,21/08/2019,08:29:44,21/08/2019,08:29:44,0247 UKT 1303617074 0819/0017012        ,0.00,1000000,20966040257.29,19082100170120000003,
3462,21/08/2019,08:31:45,21/08/2019,08:31:45,0247 UKT 1206617004 0819/0009602        ,0.00,6700000,20972740257.29,19082100096020000002,
3463,21/08/2019,08:32:37,21/08/2019,08:32:37,0247 UKT 1204617047 0819/0008219        ,0.00,5200000,20977940257.29,19082100082190000007,
3464,21/08/2019,08:36:28,21/08/2019,08:36:28,0247 UKT 1103617012 0819/0008219        ,0.00,3000000,20980940257.29,19082100082190000009,
3465,21/08/2019,08:38:12,21/08/2019,08:38:12,0247 UKT 1103617074 0819/0008219        ,0.00,3000000,20983940257.29,19082100082190000011,
3466,21/08/2019,08:40:33,21/08/2019,08:40:33,0247 UKT 1601617095 0819/0018008        ,0.00,2700000,20986640257.29,19082100180080000002,
3467,21/08/2019,08:41:02,21/08/2019,08:41:02,0247 UKT 1601617080 0819/0008594        ,0.00,5700000,20992340257.29,19082100085940000004,
3468,21/08/2019,08:41:15,21/08/2019,08:41:15,0247 UKT 1306617027 0819/0008219        ,0.00,4500000,20996840257.29,19082100082190000013,
3469,21/08/2019,08:44:24,21/08/2019,08:44:24,0247 UKT 1603617112 0819/0010403        ,0.00,6500000,21003340257.29,19082100104030000026,
3470,21/08/2019,08:46:15,21/08/2019,08:46:15,0247 UKT 1203617030 0819/0008219        ,0.00,4300000,21007640257.29,19082100082190000015,
3471,21/08/2019,08:47:43,21/08/2019,08:47:43,0247 UKT 1203618031 0819/0016995        ,0.00,5600000,21013240257.29,19082100169950000014,
3472,21/08/2019,08:52:43,21/08/2019,08:52:43,0247 UKT 1107618091 0819/0007357        ,0.00,5100000,21018340257.29,19082100073570000005,
3473,21/08/2019,08:55:53,21/08/2019,08:55:53,0247 UKT 1207618015 0819/0013080        ,0.00,6700000,21025040257.29,19082100130800000004,
3474,21/08/2019,08:57:34,21/08/2019,08:57:34,0247 UKT 1602617015 0819/0018140        ,0.00,4000000,21029040257.29,19082100181400000007,
3475,21/08/2019,08:59:44,21/08/2019,08:59:44,0247 UKT 1205617066 0819/0007758        ,0.00,5900000,21034940257.29,19082100077580000002,
3476,21/08/2019,09:01:43,21/08/2019,09:01:43,0247 UKT 1107618092 0819/0008219        ,0.00,5100000,21040040257.29,19082100082190000018,
3477,21/08/2019,09:02:15,21/08/2019,09:02:15,0247 UKT 1206618048 0819/0013482        ,0.00,4500000,21044540257.29,19082100134820000006,
3478,21/08/2019,09:04:45,21/08/2019,09:04:45,0247 UKT 1308617032 0819/0013482        ,0.00,4150000,21048690257.29,19082100134820000008,
3479,21/08/2019,09:05:41,21/08/2019,09:05:41,0247 UKT 1303617062 0819/0009665        ,0.00,3950000,21052640257.29,19082100096650000011,
3480,21/08/2019,09:06:27,21/08/2019,09:06:27,0247 UKT 1213617021 0819/0008219        ,0.00,1000000,21053640257.29,19082100082190000020,
3481,21/08/2019,09:06:58,21/08/2019,09:06:58,0247 UKT 1801618146 0819/0012481        ,0.00,8200000,21061840257.29,19082100124810000011,
3482,21/08/2019,09:07:36,21/08/2019,09:07:36,0247 UKT 1107618160 0819/0018021        ,0.00,3000000,21064840257.29,19082100180210000013,
3483,21/08/2019,09:10:46,21/08/2019,09:10:46,0247 UKT 1601617160 0819/0008163        ,0.00,3400000,21068240257.29,19082100081630000030,
3484,21/08/2019,09:11:33,21/08/2019,09:11:33,0247 UKT 1307618030 0819/0016466        ,0.00,6250000,21074490257.29,19082100164660000014,
3485,21/08/2019,09:14:07,21/08/2019,09:14:07,0247 UKT 1306618008 0819/0008219        ,0.00,4000000,21078490257.29,19082100082190000022,
3486,21/08/2019,09:15:59,21/08/2019,09:15:59,0247 UKT 1604618051 0819/0013765        ,0.00,3200000,21081690257.29,19082100137650000009,
3487,21/08/2019,09:15:59,21/08/2019,09:15:59,0247 UKT 1305617006 0819/0008219        ,0.00,6200000,21087890257.29,19082100082190000025,
3488,21/08/2019,09:17:28,21/08/2019,09:17:28,0247 UKT 1102617028 0819/0008219        ,0.00,5100000,21092990257.29,19082100082190000027,
3489,21/08/2019,09:21:50,21/08/2019,09:21:50,0247 UKT 1207617032 0819/0009561        ,0.00,4500000,21097490257.29,19082100095610000031,
3490,21/08/2019,09:28:09,21/08/2019,09:28:09,0247 UKT                                ,0.00,4700000,21102190257.29,19082199172010669580,
3491,21/08/2019,09:29:11,21/08/2019,09:29:11,0247 UKT 1107617068 0819/0006168        ,0.00,6400000,21108590257.29,19082100061680000017,
3492,21/08/2019,09:32:16,21/08/2019,09:32:16,0247 UKT 1306618025 0819/0017789        ,0.00,4000000,21112590257.29,19082100177890000023,
3493,21/08/2019,09:38:03,21/08/2019,09:38:03,0247 UKT 1601617017 0819/0018000        ,0.00,5700000,21118290257.29,19082100180000000004,
3494,21/08/2019,09:38:35,21/08/2019,09:38:35,0247 UKT 1304618022 0819/0010443        ,0.00,6200000,21124490257.29,19082100104430000030,
3495,21/08/2019,09:38:46,21/08/2019,09:38:46,0247 UKT 1104617027 0819/0008219        ,0.00,4000000,21128490257.29,19082100082190000031,
3496,21/08/2019,09:39:20,21/08/2019,09:39:20,0247 UKT 1601617154 0819/0016679        ,0.00,4000000,21132490257.29,19082100166790000013,
3497,21/08/2019,09:40:56,21/08/2019,09:40:56,0247 UKT 1304618032 0819/0008219        ,0.00,5200000,21137690257.29,19082100082190000033,
3498,21/08/2019,09:41:01,21/08/2019,09:41:01,0247 UKT 1302617054 0819/0011952        ,0.00,1000000,21138690257.29,19082100119520000021,
3499,21/08/2019,09:43:04,21/08/2019,09:43:04,0247 UKT 1305617036 0819/0017783        ,0.00,4000000,21142690257.29,19082100177830000009,
3500,21/08/2019,09:44:20,21/08/2019,09:44:20,0247 UKT 1103617018 0819/0010960        ,0.00,4000000,21146690257.29,19082100109600000010,
3501,21/08/2019,09:44:51,21/08/2019,09:44:51,0247 UKT 1303617051 0819/0011806        ,0.00,4500000,21151190257.29,19082100118060000016,
3502,21/08/2019,09:45:37,21/08/2019,09:45:37,0247 UKT 1603617041 0819/0016714        ,0.00,4300000,21155490257.29,19082100167140000049,
3503,21/08/2019,09:46:43,21/08/2019,09:46:43,0247 UKT 1603617083 0819/0017988        ,0.00,4300000,21159790257.29,19082100179880000025,
3504,21/08/2019,09:47:22,21/08/2019,09:47:22,0247 UKT 1603617025 0819/0009770        ,0.00,3200000,21162990257.29,19082100097700000033,
3505,21/08/2019,09:47:34,21/08/2019,09:47:34,0247 UKT 1603617063 0819/0010961        ,0.00,6500000,21169490257.29,19082100109610000027,
3506,21/08/2019,09:48:16,21/08/2019,09:48:16,0247 UKT 1107617244 0819/0008219        ,0.00,3000000,21172490257.29,19082100082190000035,
3507,21/08/2019,09:49:01,21/08/2019,09:49:01,0247 UKT 1603617127 0819/0007763        ,0.00,4300000,21176790257.29,19082100077630000047,
3508,21/08/2019,09:49:46,21/08/2019,09:49:46,0247 UKT 1211617029 0819/0008219        ,0.00,6200000,21182990257.29,19082100082190000037,
3509,21/08/2019,09:51:08,21/08/2019,09:51:08,0247 UKT 1107617104 0819/0008219        ,0.00,3000000,21185990257.29,19082100082190000039,
3510,21/08/2019,09:52:08,21/08/2019,09:52:08,0247 UKT 1602618065 0819/0010443        ,0.00,5700000,21191690257.29,19082100104430000035,
3511,21/08/2019,09:55:13,21/08/2019,09:55:13,0247 UKT 1107617118 0819/0013791        ,0.00,3000000,21194690257.29,19082100137910000033,
3512,21/08/2019,09:56:00,21/08/2019,09:56:00,0247 UKT 1201618053 0819/0006827        ,0.00,6700000,21201390257.29,19082100068270000035,
3513,21/08/2019,09:57:30,21/08/2019,09:57:30,0247 UKT 1205617103 0819/0008219        ,0.00,3900000,21205290257.29,19082100082190000042,
3514,21/08/2019,09:59:28,21/08/2019,09:59:28,0247 UKT 1105618038 0819/0013447        ,0.00,3000000,21208290257.29,19082100134470000005,
3515,21/08/2019,10:02:06,21/08/2019,10:02:06,0247 UKT 1601617145 0819/0167038        ,0.00,2700000,21210990257.29,19082101670380000076,
3516,21/08/2019,10:05:54,21/08/2019,10:05:54,0247 UKT 1102617082 0819/0013175        ,0.00,5100000,21216090257.29,19082100131750000038,
3517,21/08/2019,10:09:47,21/08/2019,10:09:47,0247 UKT 1211617014 0819/0010413        ,0.00,5600000,21221690257.29,19082100104130000045,
3518,21/08/2019,10:09:55,21/08/2019,10:09:55,0247 UKT 1209617042 0819/0016717        ,0.00,4500000,21226190257.29,19082100167170000006,
3519,21/08/2019,10:11:42,21/08/2019,10:11:42,0247 UKT 1107617067 0819/0018021        ,0.00,6400000,21232590257.29,19082100180210000017,
3520,21/08/2019,10:12:16,21/08/2019,10:12:16,0247 UKT 1107617201 0819/0018028        ,0.00,3900000,21236490257.29,19082100180280000004,
3521,21/08/2019,10:13:10,21/08/2019,10:13:10,0247 UKT 1602618006 0819/0017789        ,0.00,4700000,21241190257.29,19082100177890000033,
3522,21/08/2019,10:13:28,21/08/2019,10:13:28,0247 UKT 1602617044 0819/0016653        ,0.00,5700000,21246890257.29,19082100166530000034,
3523,21/08/2019,10:14:01,21/08/2019,10:14:01,0247 UKT 1105618006 0819/0008220        ,0.00,5100000,21251990257.29,19082100082200000004,
3524,21/08/2019,10:14:46,21/08/2019,10:14:46,0247 UKT 1204618027 0819/0008219        ,0.00,5900000,21257890257.29,19082100082190000045,
3525,21/08/2019,10:15:51,21/08/2019,10:15:51,0247 UKT 1301617036 0819/0017964        ,0.00,4300000,21262190257.29,19082100179640000017,
3526,21/08/2019,10:17:10,21/08/2019,10:17:10,0247 UKT 1106617065 0819/0008219        ,0.00,5800000,21267990257.29,19082100082190000047,
3527,21/08/2019,10:20:08,21/08/2019,10:20:08,0247 UKT 1208617060 0819/0012248        ,0.00,4500000,21272490257.29,19082100122480000015,
3528,21/08/2019,10:21:48,21/08/2019,10:21:48,0247 UKT 1305618026 0819/0008219        ,0.00,4000000,21276490257.29,19082100082190000051,
3529,21/08/2019,10:23:17,21/08/2019,10:23:17,0247 UKT 1203617058 0819/0008219        ,0.00,1000000,21277490257.29,19082100082190000053,
3530,21/08/2019,10:24:38,21/08/2019,10:24:38,0247 UKT 1205618043 0819/0012239        ,0.00,3900000,21281390257.29,19082100122390000005,
3531,21/08/2019,10:25:15,21/08/2019,10:25:15,0247 UKT 1107618066 0819/0008219        ,0.00,5100000,21286490257.29,19082100082190000055,
3532,21/08/2019,10:25:28,21/08/2019,10:25:28,0247 UKT 1107617284 0819/0010970        ,0.00,5100000,21291590257.29,19082100109700000010,
3533,21/08/2019,10:26:38,21/08/2019,10:26:38,0247 UKT 1302618075 0819/0008219        ,0.00,3800000,21295390257.29,19082100082190000057,
3534,21/08/2019,10:28:09,21/08/2019,10:28:09,0247 UKT 1605618027 0819/0016993        ,0.00,3200000,21298590257.29,19082100169930000009,
3535,21/08/2019,10:29:07,21/08/2019,10:29:07,0247 UKT 1602618051 0819/0008219        ,0.00,3400000,21301990257.29,19082100082190000059,
3536,21/08/2019,10:29:42,21/08/2019,10:29:42,0247 UKT 1105618075 0819/0017789        ,0.00,3000000,21304990257.29,19082100177890000037,
3537,21/08/2019,10:30:29,21/08/2019,10:30:29,0247 UKT 1602618070 0819/0008219        ,0.00,4000000,21308990257.29,19082100082190000061,
3538,21/08/2019,10:31:24,21/08/2019,10:31:24,0247 UKT 1104618052 0819/0013062        ,0.00,5300000,21314290257.29,19082100130620000066,
3539,21/08/2019,10:31:38,21/08/2019,10:31:38,0247 UKT 1602618046 0819/0008219        ,0.00,2700000,21316990257.29,19082100082190000063,
3540,21/08/2019,10:35:11,21/08/2019,10:35:11,0247 UKT 1601617207 0819/0008594        ,0.00,2700000,21319690257.29,19082100085940000020,
3541,21/08/2019,10:35:13,21/08/2019,10:35:13,0247 UKT 1604618022 0819/0017996        ,0.00,500000,21320190257.29,19082100179960000017,
3542,21/08/2019,10:35:56,21/08/2019,10:35:56,0247 UKT 1304617069 0819/0008219        ,0.00,3950000,21324140257.29,19082100082190000065,
3543,21/08/2019,10:37:00,21/08/2019,10:37:00,0247 UKT 1102617049 0819/0008219        ,0.00,3000000,21327140257.29,19082100082190000067,
3544,21/08/2019,10:39:33,21/08/2019,10:39:33,0247 UKT 1209617039 0819/0008214        ,0.00,6700000,21333840257.29,19082100082140000002,
3545,21/08/2019,10:40:29,21/08/2019,10:40:29,0247 UKT 1302618070 0819/0011541        ,0.00,3800000,21337640257.29,19082100115410000022,
3546,21/08/2019,10:40:34,21/08/2019,10:40:34,0247 UKT 1603617044 0819/0016545        ,0.00,6500000,21344140257.29,19082100165450000060,
3547,21/08/2019,10:40:49,21/08/2019,10:40:49,0247 UKT 1314618027 0819/0016658        ,0.00,4000000,21348140257.29,19082100166580000011,
3548,21/08/2019,10:43:39,21/08/2019,10:43:39,0247 UKT 1101617057 0819/0007901        ,0.00,4700000,21352840257.29,19082100079010000008,
3549,21/08/2019,10:45:09,21/08/2019,10:45:09,0247 UKT 1211617050 0819/0008214        ,0.00,5600000,21358440257.29,19082100082140000004,
3550,21/08/2019,10:45:52,21/08/2019,10:45:52,0247 UKT 1107617198 0819/0018027        ,0.00,5100000,21363540257.29,19082100180270000019,
3551,21/08/2019,10:46:26,21/08/2019,10:46:26,0247 UKT 1104618042 0819/0008219        ,0.00,4000000,21367540257.29,19082100082190000069,
3552,21/08/2019,10:49:40,21/08/2019,10:49:40,0247 UKT 1204618011 0819/0008219        ,0.00,5900000,21373440257.29,19082100082190000071,
3553,21/08/2019,10:51:53,21/08/2019,10:51:53,0247 UKT 1308617024 0819/0009593        ,0.00,4150000,21377590257.29,19082100095930000015,
3554,21/08/2019,10:52:36,21/08/2019,10:52:36,0247 UKT 1209618044 0819/0016652        ,0.00,500000,21378090257.29,19082100166520000028,
3555,21/08/2019,10:55:00,21/08/2019,10:55:00,0247 UKT 1103618074 0819/0009627        ,0.00,4000000,21382090257.29,19082100096270000051,
3556,21/08/2019,10:55:16,21/08/2019,10:55:16,0247 UKT 1209617070 0819/0016723        ,0.00,5900000,21387990257.29,19082100167230000011,
3557,21/08/2019,10:56:20,21/08/2019,10:56:20,0247 UKT                                ,0.00,4500000,21392490257.29,19082199113810324076,
3558,21/08/2019,11:01:57,21/08/2019,11:01:57,0247 UKT 1602617157 0819/0008294        ,0.00,2700000,21395190257.29,19082100082940000055,
3559,21/08/2019,11:02:00,21/08/2019,11:02:00,0247 UKT 1301617068 0819/0011547        ,0.00,3800000,21398990257.29,19082100115470000119,
3560,21/08/2019,11:03:13,21/08/2019,11:03:13,0247 UKT 1602617154 0819/0008594        ,0.00,4700000,21403690257.29,19082100085940000028,
3561,21/08/2019,11:04:16,21/08/2019,11:04:16,0247 UKT 1304618050 0819/0013799        ,0.00,3950000,21407640257.29,19082100137990000053,
3562,21/08/2019,11:05:28,21/08/2019,11:05:28,0247 UKT 1101617073 0819/0008219        ,0.00,3000000,21410640257.29,19082100082190000073,
3563,21/08/2019,11:07:15,21/08/2019,11:07:15,0247 UKT 1211618018 0819/0016714        ,0.00,6200000,21416840257.29,19082100167140000067,
3564,21/08/2019,11:08:20,21/08/2019,11:08:20,0247 UKT 1602617079 0819/0016631        ,0.00,5700000,21422540257.29,19082100166310000009,
3565,21/08/2019,11:08:56,21/08/2019,11:08:56,0247 UKT 1303618021 0819/0011802        ,0.00,6200000,21428740257.29,19082100118020000069,
3566,21/08/2019,11:09:15,21/08/2019,11:09:15,0247 UKT 1104617062 0819/0008219        ,0.00,3000000,21431740257.29,19082100082190000075,
3567,21/08/2019,11:10:03,21/08/2019,11:10:03,0247 UKT 1801618173 0819/0008567        ,0.00,6200000,21437940257.29,19082100085670000063,
3568,21/08/2019,11:11:06,21/08/2019,11:11:06,0247 UKT 1303617030 0819/0012245        ,0.00,3950000,21441890257.29,19082100122450000091,
3569,21/08/2019,11:11:21,21/08/2019,11:11:21,0247 UKT 1801617178 0819/0008246        ,0.00,4000000,21445890257.29,19082100082460000039,
3570,21/08/2019,11:15:23,21/08/2019,11:15:23,0247 UKT 1202617003 0819/0012490        ,0.00,5200000,21451090257.29,19082100124900000013,
3571,21/08/2019,11:16:21,21/08/2019,11:16:21,0247 UKT 1213617018 0819/0008219        ,0.00,3700000,21454790257.29,19082100082190000077,
3572,21/08/2019,11:17:52,21/08/2019,11:17:52,0247 UKT 1603617101 0819/0012479        ,0.00,7600000,21462390257.29,19082100124790000012,
3573,21/08/2019,11:18:28,21/08/2019,11:18:28,0247 UKT 1302617006 0819/0008219        ,0.00,3800000,21466190257.29,19082100082190000079,
3574,21/08/2019,11:19:46,21/08/2019,11:19:46,0247 UKT 1105617061 0819/0016525        ,0.00,5100000,21471290257.29,19082100165250000016,
3575,21/08/2019,11:20:19,21/08/2019,11:20:19,0247 UKT 1801617008 0819/0008219        ,0.00,4000000,21475290257.29,19082100082190000081,
3576,21/08/2019,11:24:04,21/08/2019,11:24:04,0247 UKT 1107617150 0819/0012949        ,0.00,4500000,21479790257.29,19082100129490000020,
3577,21/08/2019,11:28:36,21/08/2019,11:28:36,0247 UKT 1105618060 0819/0017017        ,0.00,5800000,21485590257.29,19082100170170000072,
3578,21/08/2019,11:30:43,21/08/2019,11:30:43,0247 UKT 1107618149 0819/0008219        ,0.00,4500000,21490090257.29,19082100082190000087,
3579,21/08/2019,11:33:47,21/08/2019,11:33:47,0247 UKT 1604618021 0819/0016989        ,0.00,3200000,21493290257.29,19082100169890000071,
3580,21/08/2019,11:35:26,21/08/2019,11:35:26,0247 UKT 1210617058 0819/0010978        ,0.00,6900000,21500190257.29,19082100109780000105,
3581,21/08/2019,11:36:29,21/08/2019,11:36:29,0247 UKT 1208617029 0819/0013072        ,0.00,5200000,21505390257.29,19082100130720000024,
3582,21/08/2019,11:39:40,21/08/2019,11:39:40,0247 UKT 1601617172 0819/0016993        ,0.00,5700000,21511090257.29,19082100169930000013,
3583,21/08/2019,11:40:50,21/08/2019,11:40:50,0247 UKT 1601617164 0819/0006827        ,0.00,4000000,21515090257.29,19082100068270000048,
3584,21/08/2019,11:41:16,21/08/2019,11:41:16,0247 UKT 1605618019 0819/0017989        ,0.00,4300000,21519390257.29,19082100179890000024,
3585,21/08/2019,11:42:18,21/08/2019,11:42:18,0247 UKT 1102618063 0819/0008219        ,0.00,10200000,21529590257.29,19082100082190000089,
3586,21/08/2019,11:43:35,21/08/2019,11:43:35,0247 UKT 1208618050 0819/0016618        ,0.00,6700000,21536290257.29,19082100166180000008,
3587,21/08/2019,11:44:29,21/08/2019,11:44:29,0247 UKT 1101618069 0819/0017989        ,0.00,3000000,21539290257.29,19082100179890000026,
3588,21/08/2019,11:44:29,21/08/2019,11:44:29,0247 UKT 1206617046 0819/0008219        ,0.00,6700000,21545990257.29,19082100082190000091,
3589,21/08/2019,11:44:30,21/08/2019,11:44:30,0247 UKT                                ,0.00,5100000,21551090257.29,19082199133260672191,
3590,21/08/2019,11:45:13,21/08/2019,11:45:13,0247 UKT 1208618015 0819/0017968        ,0.00,6700000,21557790257.29,19082100179680000027,
3591,21/08/2019,11:45:49,21/08/2019,11:45:49,0247 UKT 1602617211 0819/0011914        ,0.00,2700000,21560490257.29,19082100119140000043,
3592,21/08/2019,11:45:59,21/08/2019,11:45:59,0247 UKT 1107617072 0819/0011830        ,0.00,3000000,21563490257.29,19082100118300000049,
3593,21/08/2019,11:49:12,21/08/2019,11:49:12,0247 UKT 1201618007 0819/0008219        ,0.00,6000000,21569490257.29,19082100082190000093,
3594,21/08/2019,11:52:01,21/08/2019,11:52:01,0247 UKT 1601617118 0819/0016435        ,0.00,2700000,21572190257.29,19082100164350000062,
3595,21/08/2019,11:52:29,21/08/2019,11:52:29,0247 UKT 1603618034 0819/0010974        ,0.00,6500000,21578690257.29,19082100109740000030,
3596,21/08/2019,11:53:19,21/08/2019,11:53:19,0247 UKT 1801617226 0819/0017008        ,0.00,4000000,21582690257.29,19082100170080000037,
3597,21/08/2019,11:55:07,21/08/2019,11:55:07,0247 UKT 1203618033 0819/0011952        ,0.00,3700000,21586390257.29,19082100119520000048,
3598,21/08/2019,11:56:32,21/08/2019,11:56:32,0247 UKT 1206618037 0819/0011958        ,0.00,4500000,21590890257.29,19082100119580000072,
3599,21/08/2019,11:56:54,21/08/2019,11:56:54,0247 UKT 1102618037 0819/0006664        ,0.00,6400000,21597290257.29,19082100066640000014,
3600,21/08/2019,11:58:16,21/08/2019,11:58:16,0247 UKT 1601617024 0819/0008594        ,0.00,4700000,21601990257.29,19082100085940000033,
3601,21/08/2019,11:59:34,21/08/2019,11:59:34,0247 UKT                                ,0.00,5500000,21607490257.29,19082199113810780850,
3602,21/08/2019,12:06:49,21/08/2019,12:06:49,0247 UKT 1801617106 0819/0017002        ,0.00,8200000,21615690257.29,19082100170020000040,
3603,21/08/2019,12:07:32,21/08/2019,12:07:32,0247 UKT 1106618079 0819/0016490        ,0.00,5100000,21620790257.29,19082100164900000059,
3604,21/08/2019,12:08:07,21/08/2019,12:08:07,0247 UKT 1104617069 0819/0016628        ,0.00,1000000,21621790257.29,19082100166280000015,
3605,21/08/2019,12:08:46,21/08/2019,12:08:46,0247 UKT 1303618028 0819/0009666        ,0.00,6200000,21627990257.29,19082100096660000045,
3606,21/08/2019,12:21:45,21/08/2019,12:21:45,0247 UKT 1208617007 0819/0017787        ,0.00,5900000,21633890257.29,19082100177870000037,
3607,21/08/2019,12:21:53,21/08/2019,12:21:53,0247 UKT 1601617165 0819/0017002        ,0.00,5700000,21639590257.29,19082100170020000043,
3608,21/08/2019,12:25:12,21/08/2019,12:25:12,0247 UKT 1601617107 0819/0008594        ,0.00,1000000,21640590257.29,19082100085940000045,
3609,21/08/2019,12:25:28,21/08/2019,12:25:28,0247 UKT 1209617007 0819/0013087        ,0.00,5900000,21646490257.29,19082100130870000060,
3610,21/08/2019,12:29:43,21/08/2019,12:29:43,0247 UKT 1207618048 0819/0016715        ,0.00,4500000,21650990257.29,19082100167150000044,
3611,21/08/2019,12:32:41,21/08/2019,12:32:41,0247 UKT 1103617079 0819/0013447        ,0.00,6700000,21657690257.29,19082100134470000029,
3612,21/08/2019,12:33:18,21/08/2019,12:33:18,0247 UKT 1305618009 0819/0010443        ,0.00,1000000,21658690257.29,19082100104430000069,
3613,21/08/2019,12:34:21,21/08/2019,12:34:21,0247 UKT 1302618039 0819/0013466        ,0.00,3800000,21662490257.29,19082100134660000013,
3614,21/08/2019,12:35:16,21/08/2019,12:35:16,0247 UKT 1602617095 0819/0018024        ,0.00,4700000,21667190257.29,19082100180240000014,
3615,21/08/2019,12:37:45,21/08/2019,12:37:45,0247 UKT 1801618159 0819/0008251        ,0.00,9300000,21676490257.29,19082100082510000033,
3616,21/08/2019,12:37:50,21/08/2019,12:37:50,0247 UKT 1308618047 0819/0013462        ,0.00,5250000,21681740257.29,19082100134620000019,
3617,21/08/2019,12:39:36,21/08/2019,12:39:36,0247 UKT                                ,0.00,4000000,21685740257.29,19082199113810061726,
3618,21/08/2019,12:45:06,21/08/2019,12:45:06,0247 UKT 1801618174 0819/0008251        ,0.00,4000000,21689740257.29,19082100082510000037,
3619,21/08/2019,12:48:16,21/08/2019,12:48:16,0247 UKT 1107617235 0819/0009612        ,0.00,5100000,21694840257.29,19082100096120000040,
3620,21/08/2019,12:49:45,21/08/2019,12:49:45,0247 UKT                                ,0.00,5000000,21699840257.29,19082199369010132851,
3621,21/08/2019,12:54:39,21/08/2019,12:54:39,0247 UKT 1104617026 0819/0009627        ,0.00,4000000,21703840257.29,19082100096270000073,
3622,21/08/2019,12:55:14,21/08/2019,12:55:14,0247 UKT 1208617026 0819/0012486        ,0.00,500000,21704340257.29,19082100124860000029,
3623,21/08/2019,12:56:11,21/08/2019,12:56:11,0247 UKT 1106618082 0819/0010411        ,0.00,5100000,21709440257.29,19082100104110000028,
3624,21/08/2019,12:59:15,21/08/2019,12:59:15,0247 UKT 1101617114 0819/0013080        ,0.00,4000000,21713440257.29,19082100130800000026,
3625,21/08/2019,13:03:17,21/08/2019,13:03:17,0247 UKT 1801617245 0819/0008594        ,0.00,8200000,21721640257.29,19082100085940000047,
3626,21/08/2019,13:06:46,21/08/2019,13:06:46,0247 UKT 1103617014 0819/0008483        ,0.00,3000000,21724640257.29,19082100084830000122,
3627,21/08/2019,13:07:55,21/08/2019,13:07:55,0247 UKT 1204617051 0819/0008219        ,0.00,6400000,21731040257.29,19082100082190000098,
3628,21/08/2019,13:08:58,21/08/2019,13:08:58,0247 UKT 1301617063 0819/0008219        ,0.00,3800000,21734840257.29,19082100082190000100,
3629,21/08/2019,13:09:34,21/08/2019,13:09:34,0247 UKT 1107617171 0819/0008577        ,0.00,1000000,21735840257.29,19082100085770000018,
3630,21/08/2019,13:09:46,21/08/2019,13:09:46,0247 UKT 1601617155 0819/0007901        ,0.00,2700000,21738540257.29,19082100079010000032,
3631,21/08/2019,13:09:54,21/08/2019,13:09:54,0247 UKT 1103617064 0819/0008219        ,0.00,5300000,21743840257.29,19082100082190000102,
3632,21/08/2019,13:09:59,21/08/2019,13:09:59,0247 UKT 1605618021 0819/0017342        ,0.00,5400000,21749240257.29,19082100173420000050,
3633,21/08/2019,13:11:05,21/08/2019,13:11:05,0247 UKT 1303618014 0819/0008219        ,0.00,3950000,21753190257.29,19082100082190000104,
3634,21/08/2019,13:12:05,21/08/2019,13:12:05,0247 UKT 1105617024 0819/0016491        ,0.00,3900000,21757090257.29,19082100164910000057,
3635,21/08/2019,13:12:32,21/08/2019,13:12:32,0247 UKT 1601617163 0819/0010979        ,0.00,4000000,21761090257.29,19082100109790000081,
3636,21/08/2019,13:13:20,21/08/2019,13:13:20,0247 UKT 1307618032 0819/0008219        ,0.00,6250000,21767340257.29,19082100082190000106,
3637,21/08/2019,13:13:22,21/08/2019,13:13:22,0247 UKT                                ,0.00,6250000,21773590257.29,19082199113810297233,
3638,21/08/2019,13:14:39,21/08/2019,13:14:39,0247 UKT 1105617033 0819/0008175        ,0.00,5100000,21778690257.29,19082100081750000016,
3639,21/08/2019,13:14:48,21/08/2019,13:14:48,0247 UKT 1303618004 0819/0008219        ,0.00,3950000,21782640257.29,19082100082190000108,
3640,21/08/2019,13:16:37,21/08/2019,13:16:37,0247 UKT 1603617100 0819/0008951        ,0.00,6500000,21789140257.29,19082100089510000039,
3641,21/08/2019,13:17:32,21/08/2019,13:17:32,0247 UKT 1303618019 0819/0008219        ,0.00,6200000,21795340257.29,19082100082190000110,
3642,21/08/2019,13:18:26,21/08/2019,13:18:26,0247 UKT 1308617066 0819/0017013        ,0.00,6250000,21801590257.29,19082100170130000050,
3643,21/08/2019,13:18:58,21/08/2019,13:18:58,0247 UKT 1202617010 0819/0008219        ,0.00,6100000,21807690257.29,19082100082190000112,
3644,21/08/2019,13:20:15,21/08/2019,13:20:15,0247 UKT 1601618092 0819/0013080        ,0.00,2700000,21810390257.29,19082100130800000033,
3645,21/08/2019,13:20:38,21/08/2019,13:20:38,0247 UKT 1105618067 0819/0008219        ,0.00,5100000,21815490257.29,19082100082190000114,
3646,21/08/2019,13:20:51,21/08/2019,13:20:51,0247 UKT 1601617142 0819/0008264        ,0.00,500000,21815990257.29,19082100082640000009,
3647,21/08/2019,13:22:14,21/08/2019,13:22:14,0247 UKT 1107618137 0819/0167038        ,0.00,5100000,21821090257.29,19082101670380000255,
3648,21/08/2019,13:22:20,21/08/2019,13:22:20,0247 UKT 1107617159 0819/0012234        ,0.00,3900000,21824990257.29,19082100122340000045,
3649,21/08/2019,13:22:42,21/08/2019,13:22:42,0247 UKT 1204617003 0819/0008219        ,0.00,4500000,21829490257.29,19082100082190000116,
3650,21/08/2019,13:22:55,21/08/2019,13:22:55,0247 UKT 1604618010 0819/0008594        ,0.00,4300000,21833790257.29,19082100085940000072,
3651,21/08/2019,13:24:22,21/08/2019,13:24:22,0247 UKT 1107618013 0819/0009558        ,0.00,1000000,21834790257.29,19082100095580000076,
3652,21/08/2019,13:25:33,21/08/2019,13:25:33,0247 UKT 1602618015 0819/0016529        ,0.00,4000000,21838790257.29,19082100165290000025,
3653,21/08/2019,13:25:37,21/08/2019,13:25:37,0247 UKT 1103618072 0819/0008219        ,0.00,5300000,21844090257.29,19082100082190000118,
3654,21/08/2019,13:27:11,21/08/2019,13:27:11,0247 UKT 1603617084 0819/0018016        ,0.00,7600000,21851690257.29,19082100180160000040,
3655,21/08/2019,13:27:44,21/08/2019,13:27:44,0247 UKT 1103618070 0819/0008219        ,0.00,5300000,21856990257.29,19082100082190000120,
3656,21/08/2019,13:28:03,21/08/2019,13:28:03,0247 UKT 1103618029 0819/0011814        ,0.00,6700000,21863690257.29,19082100118140000010,
3657,21/08/2019,13:28:35,21/08/2019,13:28:35,0247 UKT 1302617042 0819/0010956        ,0.00,5000000,21868690257.29,19082100109560000074,
3658,21/08/2019,13:29:27,21/08/2019,13:29:27,0247 UKT 1304618035 0819/0008219        ,0.00,6200000,21874890257.29,19082100082190000122,
3659,21/08/2019,13:30:30,21/08/2019,13:30:30,0247 UKT 1103617116 0819/0007248        ,0.00,3000000,21877890257.29,19082100072480000014,
3660,21/08/2019,13:31:07,21/08/2019,13:31:07,0247 UKT 1314617032 0819/0018000        ,0.00,4000000,21881890257.29,19082100180000000013,
3661,21/08/2019,13:33:24,21/08/2019,13:33:24,0247 UKT 1601617115 0819/0016543        ,0.00,4700000,21886590257.29,19082100165430000072,
3662,21/08/2019,13:33:28,21/08/2019,13:33:28,0247 UKT 1314618015 0819/0008219        ,0.00,4000000,21890590257.29,19082100082190000129,
3663,21/08/2019,13:33:44,21/08/2019,13:33:44,0247 UKT 1302617043 0819/0009593        ,0.00,3800000,21894390257.29,19082100095930000038,
3664,21/08/2019,13:34:14,21/08/2019,13:34:14,0247 UKT 1602617185 0819/0008594        ,0.00,500000,21894890257.29,19082100085940000076,
3665,21/08/2019,13:34:35,21/08/2019,13:34:35,0247 UKT 1104617012 0819/0008219        ,0.00,5300000,21900190257.29,19082100082190000131,
3666,21/08/2019,13:35:31,21/08/2019,13:35:31,0247 UKT 1302618073 0819/0016670        ,0.00,1000000,21901190257.29,19082100166700000016,
3667,21/08/2019,13:35:44,21/08/2019,13:35:44,0247 UKT 1303617013 0819/0008219        ,0.00,5200000,21906390257.29,19082100082190000133,
3668,21/08/2019,13:35:47,21/08/2019,13:35:47,0247 UKT 1602617175 0819/0008594        ,0.00,2700000,21909090257.29,19082100085940000078,
3669,21/08/2019,13:35:55,21/08/2019,13:35:55,0247 UKT 1313617012 0819/0006710        ,0.00,6200000,21915290257.29,19082100067100000023,
3670,21/08/2019,13:36:19,21/08/2019,13:36:19,0247 UKT 1211617026 0819/0010413        ,0.00,5600000,21920890257.29,19082100104130000081,
3671,21/08/2019,13:36:51,21/08/2019,13:36:51,0247 UKT 1602617176 0819/0008594        ,0.00,500000,21921390257.29,19082100085940000080,
3672,21/08/2019,13:36:51,21/08/2019,13:36:51,0247 UKT 1308618027 0819/0016716        ,0.00,6250000,21927640257.29,19082100167160000036,
3673,21/08/2019,13:37:09,21/08/2019,13:37:09,0247 UKT 1601618086 0819/0008219        ,0.00,4700000,21932340257.29,19082100082190000135,
3674,21/08/2019,13:37:24,21/08/2019,13:37:24,0247 UKT 1208618038 0819/0010516        ,0.00,4500000,21936840257.29,19082100105160000074,
3675,21/08/2019,13:37:54,21/08/2019,13:37:54,0247 UKT 1601617223 0819/0008574        ,0.00,4000000,21940840257.29,19082100085740000045,
3676,21/08/2019,13:38:19,21/08/2019,13:38:19,0247 UKT 1601617106 0819/0008594        ,0.00,500000,21941340257.29,19082100085940000082,
3677,21/08/2019,13:39:56,21/08/2019,13:39:56,0247 UKT 1601618099 0819/0008594        ,0.00,500000,21941840257.29,19082100085940000085,
3678,21/08/2019,13:40:36,21/08/2019,13:40:36,0247 UKT 1101617053 0819/0008219        ,0.00,4000000,21945840257.29,19082100082190000140,
3679,21/08/2019,13:41:08,21/08/2019,13:41:08,0247 UKT 1602617026 0819/0008594        ,0.00,2700000,21948540257.29,19082100085940000087,
3680,21/08/2019,13:41:17,21/08/2019,13:41:17,0247 UKT 1106617068 0819/0008219        ,0.00,3900000,21952440257.29,19082100082190000142,
3681,21/08/2019,13:41:24,21/08/2019,13:41:24,0247 UKT 1105618022 0819/0009253        ,0.00,3900000,21956340257.29,19082100092530000049,
3682,21/08/2019,13:42:11,21/08/2019,13:42:11,0247 UKT 1103617069 0819/0008219        ,0.00,500000,21956840257.29,19082100082190000144,
3683,21/08/2019,13:43:35,21/08/2019,13:43:35,0247 UKT 1601617218 0819/0013785        ,0.00,4700000,21961540257.29,19082100137850000072,
3684,21/08/2019,13:43:46,21/08/2019,13:43:46,0247 UKT 1205618063 0819/0013799        ,0.00,5900000,21967440257.29,19082100137990000064,
3685,21/08/2019,13:44:35,21/08/2019,13:44:35,0247 UKT 1601617217 0819/0011952        ,0.00,1000000,21968440257.29,19082100119520000056,
3686,21/08/2019,13:45:22,21/08/2019,13:45:22,0247 UKT 1205617099 0819/0011823        ,0.00,4500000,21972940257.29,19082100118230000051,
3687,21/08/2019,13:45:36,21/08/2019,13:45:36,0247 UKT 1209618036 0819/0010423        ,0.00,5900000,21978840257.29,19082100104230000046,
3688,21/08/2019,13:47:16,21/08/2019,13:47:16,0247 UKT 1301617048 0819/0008281        ,0.00,3800000,21982640257.29,19082100082810000009,
3689,21/08/2019,13:47:41,21/08/2019,13:47:41,0247 UKT                                ,0.00,4700000,21987340257.29,19082199113810537216,
3690,21/08/2019,13:49:03,21/08/2019,13:49:03,0247 UKT 1205618051 0819/0008219        ,0.00,4500000,21991840257.29,19082100082190000148,
3691,21/08/2019,13:49:10,21/08/2019,13:49:10,0247 UKT 1210617024 0819/0009587        ,0.00,4600000,21996440257.29,19082100095870000094,
3692,21/08/2019,13:49:36,21/08/2019,13:49:36,0247 UKT 1601617050 0819/0006669        ,0.00,2700000,21999140257.29,19082100066690000118,
3693,21/08/2019,13:49:51,21/08/2019,13:49:51,0247 UKT 1601617117 0819/0016587        ,0.00,500000,21999640257.29,19082100165870000034,
3694,21/08/2019,13:50:53,21/08/2019,13:50:53,0247 UKT 1210618066 0819/0008219        ,0.00,4600000,22004240257.29,19082100082190000150,
3695,21/08/2019,13:50:54,21/08/2019,13:50:54,0247 UKT 1306617036 0819/0011932        ,0.00,6200000,22010440257.29,19082100119320000017,
3696,21/08/2019,13:52:23,21/08/2019,13:52:23,0247 UKT 1602618077 0819/0008219        ,0.00,1000000,22011440257.29,19082100082190000152,
3697,21/08/2019,13:53:34,21/08/2019,13:53:34,0247 UKT 1107617057 0819/0008219        ,0.00,1000000,22012440257.29,19082100082190000154,
3698,21/08/2019,13:54:02,21/08/2019,13:54:02,0247 UKT 1202617048 0819/0009593        ,0.00,4500000,22016940257.29,19082100095930000041,
3699,21/08/2019,13:54:41,21/08/2019,13:54:41,0247 UKT 1306618015 0819/0016619        ,0.00,1000000,22017940257.29,19082100166190000033,
3700,21/08/2019,13:58:19,21/08/2019,13:58:19,0247 UKT 1204618050 0819/0008219        ,0.00,6100000,22024040257.29,19082100082190000158,
3701,21/08/2019,13:59:09,21/08/2019,13:59:09,0247 UKT 1801618098 0819/0013785        ,0.00,4000000,22028040257.29,19082100137850000084,
3702,21/08/2019,13:59:18,21/08/2019,13:59:18,0247 UKT 1103617059 0819/0008219        ,0.00,4000000,22032040257.29,19082100082190000160,
3703,21/08/2019,13:59:20,21/08/2019,13:59:20,0247 UKT 1209617054 0819/0010462        ,0.00,6700000,22038740257.29,19082100104620000088,
3704,21/08/2019,13:59:35,21/08/2019,13:59:35,0247 UKT 1104617054 0819/0017017        ,0.00,3000000,22041740257.29,19082100170170000082,
3705,21/08/2019,13:59:50,21/08/2019,13:59:50,0247 UKT 1602617199 0819/0017789        ,0.00,4700000,22046440257.29,19082100177890000069,
3706,21/08/2019,14:01:04,21/08/2019,14:01:04,0247 UKT 1203618023 0819/0008219        ,0.00,5600000,22052040257.29,19082100082190000162,
3707,21/08/2019,14:01:22,21/08/2019,14:01:22,0247 UKT 1603617035 0819/0016438        ,0.00,500000,22052540257.29,19082100164380000024,
3708,21/08/2019,14:01:51,21/08/2019,14:01:51,0247 UKT 1103617047 0819/0016525        ,0.00,4700000,22057240257.29,19082100165250000033,
3709,21/08/2019,14:02:13,21/08/2019,14:02:13,0247 UKT 1601618098 0819/0011952        ,0.00,1000000,22058240257.29,19082100119520000063,
3710,21/08/2019,14:02:27,21/08/2019,14:02:27,0247 UKT 1307618029 0819/0008219        ,0.00,4150000,22062390257.29,19082100082190000164,
3711,21/08/2019,14:02:32,21/08/2019,14:02:32,0247 UKT 1105618071 0819/0017012        ,0.00,3000000,22065390257.29,19082100170120000090,
3712,21/08/2019,14:03:41,21/08/2019,14:03:41,0247 UKT 1302617044 0819/0008219        ,0.00,3800000,22069190257.29,19082100082190000167,
3713,21/08/2019,14:04:24,21/08/2019,14:04:24,0247 UKT 1103617086 0819/0017789        ,0.00,6000000,22075190257.29,19082100177890000071,
3714,21/08/2019,14:05:12,21/08/2019,14:05:12,0247 UKT 1103617072 0819/0016490        ,0.00,3000000,22078190257.29,19082100164900000066,
3715,21/08/2019,14:05:14,21/08/2019,14:05:14,0247 UKT 1106617074 0819/0017977        ,0.00,5800000,22083990257.29,19082100179770000051,
3716,21/08/2019,14:05:20,21/08/2019,14:05:20,0247 UKT 1203618041 0819/0010758        ,0.00,1000000,22084990257.29,19082100107580000028,
3717,21/08/2019,14:05:50,21/08/2019,14:05:50,0247 UKT 1208617004 0819/0006635        ,0.00,7100000,22092090257.29,19082100066350000095,
3718,21/08/2019,14:05:51,21/08/2019,14:05:51,0247 UKT 1801618170 0819/0009659        ,0.00,4000000,22096090257.29,19082100096590000043,
3719,21/08/2019,14:06:45,21/08/2019,14:06:45,0247 UKT 1210618065 0819/0008207        ,0.00,1000000,22097090257.29,19082100082070000070,
3720,21/08/2019,14:07:04,21/08/2019,14:07:04,0247 UKT 1210618030 0819/0013442        ,0.00,4600000,22101690257.29,19082100134420000061,
3721,21/08/2019,14:07:22,21/08/2019,14:07:22,0247 UKT 1210618044 0819/0012936        ,0.00,4600000,22106290257.29,19082100129360000048,
3722,21/08/2019,14:08:03,21/08/2019,14:08:03,0247 UKT 1603617045 0819/0008594        ,0.00,1000000,22107290257.29,19082100085940000089,
3723,21/08/2019,14:08:22,21/08/2019,14:08:22,0247 UKT 1303617077 0819/0017987        ,0.00,3950000,22111240257.29,19082100179870000038,
3724,21/08/2019,14:10:03,21/08/2019,14:10:03,0247 UKT 1209617056 0819/0012479        ,0.00,6700000,22117940257.29,19082100124790000018,
3725,21/08/2019,14:10:46,21/08/2019,14:10:46,0247 UKT                                ,0.00,3700000,22121640257.29,19082199113810704196,
3726,21/08/2019,14:10:50,21/08/2019,14:10:50,0247 UKT 1601617146 0819/0010974        ,0.00,4700000,22126340257.29,19082100109740000057,
3727,21/08/2019,14:11:20,21/08/2019,14:11:20,0247 UKT 1602617205 0819/0012491        ,0.00,5400000,22131740257.29,19082100124910000106,
3728,21/08/2019,14:11:36,21/08/2019,14:11:36,0247 UKT 1201618049 0819/0017744        ,0.00,1000000,22132740257.29,19082100177440000028,
3729,21/08/2019,14:11:40,21/08/2019,14:11:40,0247 UKT 1206618011 0819/0008219        ,0.00,6700000,22139440257.29,19082100082190000169,
3730,21/08/2019,14:11:47,21/08/2019,14:11:47,0247 UKT 1205618103 0819/0007019        ,0.00,1000000,22140440257.29,19082100070190000062,
3731,21/08/2019,14:11:53,21/08/2019,14:11:53,0247 UKT 1601618045 0819/0007901        ,0.00,2700000,22143140257.29,19082100079010000036,
3732,21/08/2019,14:12:59,21/08/2019,14:12:59,0247 UKT 1104617112 0819/0018021        ,0.00,4000000,22147140257.29,19082100180210000053,
3733,21/08/2019,14:15:21,21/08/2019,14:15:21,0247 UKT 1206618051 0819/0008219        ,0.00,4500000,22151640257.29,19082100082190000171,
3734,21/08/2019,14:16:32,21/08/2019,14:16:32,0247 UKT 1601617171 0819/0012477        ,0.00,2700000,22154340257.29,19082100124770000027,
3735,21/08/2019,14:17:00,21/08/2019,14:17:00,0247 UKT 1206618008 0819/0008219        ,0.00,4500000,22158840257.29,19082100082190000173,
3736,21/08/2019,14:17:40,21/08/2019,14:17:40,0247 UKT 1207617053 0819/0009748        ,0.00,4500000,22163340257.29,19082100097480000039,
3737,21/08/2019,14:17:46,21/08/2019,14:17:46,0247 UKT 1105617059 0819/0018021        ,0.00,5100000,22168440257.29,19082100180210000055,
3738,21/08/2019,14:19:08,21/08/2019,14:19:08,0247 UKT 1206618041 0819/0008219        ,0.00,6700000,22175140257.29,19082100082190000175,
3739,21/08/2019,14:20:29,21/08/2019,14:20:29,0247 UKT 1603618027 0819/0006168        ,0.00,6500000,22181640257.29,19082100061680000055,
3740,21/08/2019,14:20:30,21/08/2019,14:20:30,0247 UKT 1107617181 0819/0007900        ,0.00,5800000,22187440257.29,19082100079000000012,
3741,21/08/2019,14:21:07,21/08/2019,14:21:07,0247 UKT                                ,0.00,6700000,22194140257.29,19082199113810776777,
3742,21/08/2019,14:21:26,21/08/2019,14:21:26,0247 UKT 1213618024 0819/0008219        ,0.00,5000000,22199140257.29,19082100082190000177,
3743,21/08/2019,14:25:01,21/08/2019,14:25:01,0247 UKT 1102618009 0819/0007337        ,0.00,3000000,22202140257.29,19082100073370000026,
3744,21/08/2019,14:25:45,21/08/2019,14:25:45,0247 UKT 1209617045 0819/0013469        ,0.00,6700000,22208840257.29,19082100134690000046,
3745,21/08/2019,14:26:52,21/08/2019,14:26:52,0247 UKT 1211618041 0819/0008219        ,0.00,5600000,22214440257.29,19082100082190000179,
3746,21/08/2019,14:27:22,21/08/2019,14:27:22,0247 UKT 1302618052 0819/0013486        ,0.00,3800000,22218240257.29,19082100134860000115,
3747,21/08/2019,14:27:23,21/08/2019,14:27:23,0247 UKT 1602617012 0819/0011547        ,0.00,1000000,22219240257.29,19082100115470000236,
3748,21/08/2019,15:20:09,21/08/2019,15:20:09,0247 UKT 1308618019 0819/0016670        ,0.00,4150000,22223390257.29,19082100166700000024,
3749,21/08/2019,15:20:41,21/08/2019,15:20:41,0247 UKT 1602617140 0819/0012490        ,0.00,2700000,22226090257.29,19082100124900000044,
3750,21/08/2019,15:38:54,21/08/2019,15:38:54,0247 UKT                                ,0.00,4600000,22230690257.29,19082199113810304783,
3751,21/08/2019,16:00:10,21/08/2019,16:00:10,0247 UKT                                ,0.00,6200000,22236890257.29,19082199212010507620,
3752,21/08/2019,16:00:37,21/08/2019,16:00:37,0247 UKT 1208618027 0819/0017356        ,0.00,5200000,22242090257.29,19082100173560000084,
3753,21/08/2019,16:27:34,21/08/2019,16:27:34,0247 UKT                                ,0.00,4150000,22246240257.29,19082199105710706238,
3754,21/08/2019,16:33:31,21/08/2019,16:33:31,0247 UKT                                ,0.00,7400000,22253640257.29,19082199592010749009,
3755,21/08/2019,16:48:00,21/08/2019,16:48:00,0247 UKT                                ,0.00,5200000,22258840257.29,19082199179020857245,
3756,21/08/2019,16:49:26,21/08/2019,16:49:26,0247 UKT                                ,0.00,4000000,22262840257.29,19082199254010867941,
3757,21/08/2019,17:14:33,21/08/2019,17:14:33,0247 UKT                                ,0.00,8200000,22271040257.29,19082199600010051485,
3758,21/08/2019,17:34:57,21/08/2019,17:34:57,0247 UKT                                ,0.00,5900000,22276940257.29,19082199309010200572,
3759,21/08/2019,19:23:38,21/08/2019,19:23:38,0247 UKT                                ,0.00,5100000,22282040257.29,19082199054010954173,
3760,21/08/2019,19:59:42,21/08/2019,19:59:42,0247 UKT                                ,0.00,1000000,22283040257.29,19082199662010206179,
3761,21/08/2019,20:00:43,21/08/2019,20:00:43,0247 UKT                                ,0.00,5900000,22288940257.29,19082199113810213468,
3762,21/08/2019,20:47:03,21/08/2019,20:47:03,0247 UKT                                ,0.00,5300000,22294240257.29,19082199144010514515,
3763,21/08/2019,22:34:35,21/08/2019,22:34:35,0247 UKT                                ,0.00,6700000,22300940257.29,19082199281010032205,
3764,22/08/2019,07:00:58,22/08/2019,07:00:58,0247 UKT                                ,0.00,6700000,22307640257.29,19082299113810654448,
3765,22/08/2019,07:08:56,22/08/2019,07:08:56,0247 UKT                                ,0.00,4000000,22311640257.29,19082299545010699803,
3766,22/08/2019,07:13:27,22/08/2019,07:13:27,0247 UKT                                ,0.00,5100000,22316740257.29,19082299257020725782,
3767,22/08/2019,07:24:29,22/08/2019,07:24:29,0247 UKT                                ,0.00,4500000,22321240257.29,19082299113810788668,
3768,22/08/2019,07:53:43,22/08/2019,07:53:43,0247 UKT                                ,0.00,7300000,22328540257.29,19082299113810965205,
3769,22/08/2019,08:03:47,22/08/2019,08:03:47,0247 UKT 1601617082 0819/0018000        ,0.00,4000000,22332540257.29,19082200180000000002,
3770,22/08/2019,08:03:51,22/08/2019,08:03:51,0247 UKT 1314617004 0819/0006786        ,0.00,4000000,22336540257.29,19082200067860000004,
3771,22/08/2019,08:07:52,22/08/2019,08:07:52,0247 UKT 1603617114 0819/0008594        ,0.00,6500000,22343040257.29,19082200085940000002,
3772,22/08/2019,08:09:00,22/08/2019,08:09:00,0247 UKT 1602617097 0819/0009748        ,0.00,4000000,22347040257.29,19082200097480000002,
3773,22/08/2019,08:09:47,22/08/2019,08:09:47,0247 UKT 1307618004 0819/0006338        ,0.00,4150000,22351190257.29,19082200063380000006,
3774,22/08/2019,08:10:35,22/08/2019,08:10:35,0247 UKT                                ,0.00,5400000,22356590257.29,19082299136020072342,
3775,22/08/2019,08:11:29,22/08/2019,08:11:29,0247 UKT 1101618050 0819/0017744        ,0.00,5300000,22361890257.29,19082200177440000002,
3776,22/08/2019,08:14:05,22/08/2019,08:14:05,0247 UKT 1601617028 0819/0010977        ,0.00,1000000,22362890257.29,19082200109770000004,
3777,22/08/2019,08:15:47,22/08/2019,08:15:47,0247 UKT 1203617008 0819/0016441        ,0.00,5600000,22368490257.29,19082200164410000008,
3778,22/08/2019,08:19:18,22/08/2019,08:19:18,0247 UKT 1801617173 0819/0016618        ,0.00,4000000,22372490257.29,19082200166180000003,
3779,22/08/2019,08:19:33,22/08/2019,08:19:33,0247 UKT 1204617020 0819/0016996        ,0.00,3900000,22376390257.29,19082200169960000005,
3780,22/08/2019,08:23:43,22/08/2019,08:23:43,0247 UKT 1604618013 0819/0007019        ,0.00,7600000,22383990257.29,19082200070190000004,
3781,22/08/2019,08:25:34,22/08/2019,08:25:34,0247 UKT 1103618077 0819/0017342        ,0.00,4000000,22387990257.29,19082200173420000009,
3782,22/08/2019,08:27:52,22/08/2019,08:27:52,0247 UKT 1205618007 0819/0017997        ,0.00,3900000,22391890257.29,19082200179970000002,
3783,22/08/2019,08:28:01,22/08/2019,08:28:01,0247 UKT 1303617040 0819/0008219        ,0.00,6200000,22398090257.29,19082200082190000002,
3784,22/08/2019,08:28:36,22/08/2019,08:28:36,0247 UKT 1601617191 0819/0013436        ,0.00,4000000,22402090257.29,19082200134360000004,
3785,22/08/2019,08:34:22,22/08/2019,08:34:22,0247 UKT 1104617083 0819/0016442        ,0.00,3000000,22405090257.29,19082200164420000014,
3786,22/08/2019,08:39:25,22/08/2019,08:39:25,0247 UKT 1305618006 0819/0018233        ,0.00,1000000,22406090257.29,19082200182330000003,
3787,22/08/2019,08:40:16,22/08/2019,08:40:16,0247 UKT 1101617084 0819/0008219        ,0.00,3000000,22409090257.29,19082200082190000004,
3788,22/08/2019,08:41:28,22/08/2019,08:41:28,0247 UKT 1801617127 0819/0013080        ,0.00,8200000,22417290257.29,19082200130800000002,
3789,22/08/2019,08:41:56,22/08/2019,08:41:56,0247 UKT 1314618007 0819/0008219        ,0.00,4000000,22421290257.29,19082200082190000006,
3790,22/08/2019,08:43:46,22/08/2019,08:43:46,0247 UKT 1206618056 0819/0011916        ,0.00,6700000,22427990257.29,19082200119160000004,
3791,22/08/2019,08:47:15,22/08/2019,08:47:15,0247 UKT 1202618028 0819/0008219        ,0.00,3900000,22431890257.29,19082200082190000008,
3792,22/08/2019,08:47:28,22/08/2019,08:47:28,0247 UKT 1106618045 0819/0016587        ,0.00,5100000,22436990257.29,19082200165870000002,
3793,22/08/2019,08:47:35,22/08/2019,08:47:35,0247 UKT 1203617041 0819/0012245        ,0.00,6200000,22443190257.29,19082200122450000011,
3794,22/08/2019,08:48:44,22/08/2019,08:48:44,0247 UKT 1104617008 0819/0012479        ,0.00,3000000,22446190257.29,19082200124790000006,
3795,22/08/2019,08:49:44,22/08/2019,08:49:44,0247 UKT 1104618060 0819/0010961        ,0.00,4000000,22450190257.29,19082200109610000008,
3796,22/08/2019,08:55:54,22/08/2019,08:55:54,0247 UKT 1101617069 0819/0016716        ,0.00,6700000,22456890257.29,19082200167160000019,
3797,22/08/2019,08:56:25,22/08/2019,08:56:25,0247 UKT 1602617042 0819/0017002        ,0.00,3400000,22460290257.29,19082200170020000004,
3798,22/08/2019,08:58:39,22/08/2019,08:58:39,0247 UKT 1204617009 0819/0008219        ,0.00,4500000,22464790257.29,19082200082190000010,
3799,22/08/2019,09:00:02,22/08/2019,09:00:02,0247 UKT 1308618032 0819/0009574        ,0.00,6250000,22471040257.29,19082200095740000011,
3800,22/08/2019,09:04:41,22/08/2019,09:04:41,0247 UKT 1801618106 0819/0011830        ,0.00,8200000,22479240257.29,19082200118300000026,
3801,22/08/2019,09:04:42,22/08/2019,09:04:42,0247 UKT 1205617061 0819/0008219        ,0.00,3900000,22483140257.29,19082200082190000012,
3802,22/08/2019,09:04:45,22/08/2019,09:04:45,0247 UKT 1602617117 0819/0008594        ,0.00,3400000,22486540257.29,19082200085940000006,
3803,22/08/2019,09:07:40,22/08/2019,09:07:40,0247 UKT 1301617075 0819/0010444        ,0.00,6000000,22492540257.29,19082200104440000034,
3804,22/08/2019,09:09:42,22/08/2019,09:09:42,0247 UKT 1303617049 0819/0008219        ,0.00,3950000,22496490257.29,19082200082190000014,
3805,22/08/2019,09:10:59,22/08/2019,09:10:59,0247 UKT 1204617008 0819/0008219        ,0.00,3900000,22500390257.29,19082200082190000016,
3806,22/08/2019,09:12:52,22/08/2019,09:12:52,0247 UKT 1211617030 0819/0009701        ,0.00,5600000,22505990257.29,19082200097010000002,
3807,22/08/2019,09:15:43,22/08/2019,09:15:43,0247 UKT 1303618008 0819/0012236        ,0.00,3950000,22509940257.29,19082200122360000003,
3808,22/08/2019,09:15:47,22/08/2019,09:15:47,0247 UKT 1801617183 0819/0008219        ,0.00,6200000,22516140257.29,19082200082190000018,
3809,22/08/2019,09:18:09,22/08/2019,09:18:09,0247 UKT 1314617022 0819/0017000        ,0.00,7300000,22523440257.29,19082200170000000023,
3810,22/08/2019,09:18:28,22/08/2019,09:18:28,0247 UKT 1303617034 0819/0008219        ,0.00,5200000,22528640257.29,19082200082190000022,
3811,22/08/2019,09:19:08,22/08/2019,09:19:08,0247 UKT 1304617028 0819/0011806        ,0.00,3950000,22532590257.29,19082200118060000051,
3812,22/08/2019,09:19:38,22/08/2019,09:19:38,0247 UKT 1306617003 0819/0008219        ,0.00,4000000,22536590257.29,19082200082190000024,
3813,22/08/2019,09:19:38,22/08/2019,09:19:38,0247 UKT 1314618030 0819/0007754        ,0.00,6400000,22542990257.29,19082200077540000030,
3814,22/08/2019,09:20:08,22/08/2019,09:20:08,0247 UKT 1101617021 0819/0013465        ,0.00,3000000,22545990257.29,19082200134650000015,
3815,22/08/2019,09:22:01,22/08/2019,09:22:01,0247 UKT 1103618084 0819/0018003        ,0.00,4000000,22549990257.29,19082200180030000005,
3816,22/08/2019,09:23:53,22/08/2019,09:23:53,0247 UKT 1604618011 0819/0016437        ,0.00,6500000,22556490257.29,19082200164370000008,
3817,22/08/2019,09:25:03,22/08/2019,09:25:03,0247 UKT 1303617079 0819/0008219        ,0.00,1000000,22557490257.29,19082200082190000027,
3818,22/08/2019,09:26:06,22/08/2019,09:26:06,0247 UKT 1303617038 0819/0008219        ,0.00,3950000,22561440257.29,19082200082190000029,
3819,22/08/2019,09:26:07,22/08/2019,09:26:07,0247 UKT 1605618029 0819/0009574        ,0.00,6500000,22567940257.29,19082200095740000023,
3820,22/08/2019,09:27:24,22/08/2019,09:27:24,0247 UKT 1601618016 0819/0017995        ,0.00,2700000,22570640257.29,19082200179950000004,
3821,22/08/2019,09:27:28,22/08/2019,09:27:28,0247 UKT 1303617045 0819/0008219        ,0.00,3950000,22574590257.29,19082200082190000031,
3822,22/08/2019,09:30:27,22/08/2019,09:30:27,0247 UKT 1313617028 0819/0008219        ,0.00,4000000,22578590257.29,19082200082190000033,
3823,22/08/2019,09:33:34,22/08/2019,09:33:34,0247 UKT 1301617032 0819/0008219        ,0.00,3800000,22582390257.29,19082200082190000035,
3824,22/08/2019,09:35:38,22/08/2019,09:35:38,0247 UKT 1601617152 0819/0017768        ,0.00,1000000,22583390257.29,19082200177680000014,
3825,22/08/2019,09:39:03,22/08/2019,09:39:03,0247 UKT 1106618042 0819/0010960        ,0.00,5100000,22588490257.29,19082200109600000011,
3826,22/08/2019,09:41:21,22/08/2019,09:41:21,0247 UKT 1303618037 0819/0017000        ,0.00,3950000,22592440257.29,19082200170000000040,
3827,22/08/2019,09:43:08,22/08/2019,09:43:08,0247 UKT 1301617012 0819/0011547        ,0.00,3800000,22596240257.29,19082200115470000047,
3828,22/08/2019,09:43:58,22/08/2019,09:43:58,0247 UKT 1107617056 0819/0013446        ,0.00,3900000,22600140257.29,19082200134460000015,
3829,22/08/2019,09:44:21,22/08/2019,09:44:21,0247 UKT 1107617028 0819/0013446        ,0.00,3000000,22603140257.29,19082200134460000017,
3830,22/08/2019,09:44:38,22/08/2019,09:44:38,0247 UKT 1107618155 0819/0007887        ,0.00,3000000,22606140257.29,19082200078870000028,
3831,22/08/2019,09:45:26,22/08/2019,09:45:26,0247 UKT 1101618021 0819/0017002        ,0.00,4000000,22610140257.29,19082200170020000015,
3832,22/08/2019,09:49:07,22/08/2019,09:49:07,0247 UKT 1801618055 0819/0009612        ,0.00,4000000,22614140257.29,19082200096120000010,
3833,22/08/2019,09:51:15,22/08/2019,09:51:15,0247 UKT 1304618011 0819/0016438        ,0.00,3950000,22618090257.29,19082200164380000006,
3834,22/08/2019,09:51:42,22/08/2019,09:51:42,0247 UKT 1103618068 0819/0008219        ,0.00,3000000,22621090257.29,19082200082190000039,
3835,22/08/2019,09:51:47,22/08/2019,09:51:47,0247 UKT                                ,0.00,3700000,22624790257.29,19082299113810781645,
3836,22/08/2019,09:53:42,22/08/2019,09:53:42,0247 UKT 1303618057 0819/0017009        ,0.00,5200000,22629990257.29,19082200170090000037,
3837,22/08/2019,09:54:38,22/08/2019,09:54:38,0247 UKT 1207618045 0819/0009593        ,0.00,4500000,22634490257.29,19082200095930000008,
3838,22/08/2019,09:55:04,22/08/2019,09:55:04,0247 UKT 1210617061 0819/0008219        ,0.00,4600000,22639090257.29,19082200082190000041,
3839,22/08/2019,09:55:45,22/08/2019,09:55:45,0247 UKT 1209617065 0819/0012245        ,0.00,6700000,22645790257.29,19082200122450000023,
3840,22/08/2019,09:56:09,22/08/2019,09:56:09,0247 UKT 1302617041 0819/0008219        ,0.00,3800000,22649590257.29,19082200082190000043,
3841,22/08/2019,09:57:44,22/08/2019,09:57:44,0247 UKT 1201617076 0819/0008219        ,0.00,4000000,22653590257.29,19082200082190000045,
3842,22/08/2019,09:59:07,22/08/2019,09:59:07,0247 UKT 1213618016 0819/0008219        ,0.00,5600000,22659190257.29,19082200082190000047,
3843,22/08/2019,10:02:52,22/08/2019,10:02:52,0247 UKT 1203618007 0819/0008219        ,0.00,5600000,22664790257.29,19082200082190000049,
3844,22/08/2019,10:03:29,22/08/2019,10:03:29,0247 UKT 1107618152 0819/0017009        ,0.00,12800000,22677590257.29,19082200170090000041,
3845,22/08/2019,10:04:17,22/08/2019,10:04:17,0247 UKT 1601618065 0819/0008219        ,0.00,4700000,22682290257.29,19082200082190000051,
3846,22/08/2019,10:08:26,22/08/2019,10:08:26,0247 UKT 1603617141 0819/0016583        ,0.00,4300000,22686590257.29,19082200165830000042,
3847,22/08/2019,10:08:35,22/08/2019,10:08:35,0247 UKT 1313617037 0819/0013447        ,0.00,8000000,22694590257.29,19082200134470000021,
3848,22/08/2019,10:08:58,22/08/2019,10:08:58,0247 UKT 1105618065 0819/0016714        ,0.00,500000,22695090257.29,19082200167140000017,
3849,22/08/2019,10:09:10,22/08/2019,10:09:10,0247 UKT 1603618037 0819/0008219        ,0.00,6500000,22701590257.29,19082200082190000053,
3850,22/08/2019,10:10:48,22/08/2019,10:10:48,0247 UKT 1208618016 0819/0008207        ,0.00,6700000,22708290257.29,19082200082070000031,
3851,22/08/2019,10:11:24,22/08/2019,10:11:24,0247 UKT 1205617091 0819/0008219        ,0.00,5900000,22714190257.29,19082200082190000055,
3852,22/08/2019,10:12:09,22/08/2019,10:12:09,0247 UKT 1213617025 0819/0016631        ,0.00,5600000,22719790257.29,19082200166310000004,
3853,22/08/2019,10:13:25,22/08/2019,10:13:25,0247 UKT 1307618033 0819/0017000        ,0.00,6250000,22726040257.29,19082200170000000048,
3854,22/08/2019,10:14:31,22/08/2019,10:14:31,0247 UKT 1602618037 0819/0008594        ,0.00,1000000,22727040257.29,19082200085940000014,
3855,22/08/2019,10:14:41,22/08/2019,10:14:41,0247 UKT 1105617052 0819/0018139        ,0.00,5100000,22732140257.29,19082200181390000013,
3856,22/08/2019,10:16:19,22/08/2019,10:16:19,0247 UKT 1602617111 0819/0008594        ,0.00,1000000,22733140257.29,19082200085940000016,
3857,22/08/2019,10:16:25,22/08/2019,10:16:25,0247 UKT 1208618042 0819/0007770        ,0.00,5900000,22739040257.29,19082200077700000009,
3858,22/08/2019,10:18:43,22/08/2019,10:18:43,0247 UKT 1602617091 0819/0008594        ,0.00,2700000,22741740257.29,19082200085940000018,
3859,22/08/2019,10:21:01,22/08/2019,10:21:01,0247 UKT 1601617045 0819/0012476        ,0.00,500000,22742240257.29,19082200124760000025,
3860,22/08/2019,10:23:36,22/08/2019,10:23:36,0247 UKT 1206617006 0819/0016660        ,0.00,5200000,22747440257.29,19082200166600000004,
3861,22/08/2019,10:24:25,22/08/2019,10:24:25,0247 UKT 1602617164 0819/0007900        ,0.00,500000,22747940257.29,19082200079000000012,
3862,22/08/2019,10:26:21,22/08/2019,10:26:21,0247 UKT 1107618098 0819/0010977        ,0.00,5100000,22753040257.29,19082200109770000016,
3863,22/08/2019,10:26:49,22/08/2019,10:26:49,0247 UKT 1210617035 0819/0013498        ,0.00,4600000,22757640257.29,19082200134980000013,
3864,22/08/2019,10:31:59,22/08/2019,10:31:59,0247 UKT 1205618055 0819/0017001        ,0.00,3900000,22761540257.29,19082200170010000008,
3865,22/08/2019,10:32:36,22/08/2019,10:32:36,0247 UKT 1104618078 0819/0018004        ,0.00,4000000,22765540257.29,19082200180040000003,
3866,22/08/2019,10:35:27,22/08/2019,10:35:27,0247 UKT 1601618019 0819/0012490        ,0.00,4000000,22769540257.29,19082200124900000026,
3867,22/08/2019,10:35:33,22/08/2019,10:35:33,0247 UKT 1206618055 0819/0016719        ,0.00,4500000,22774040257.29,19082200167190000019,
3868,22/08/2019,10:36:27,22/08/2019,10:36:27,0247 UKT 1801617293 0819/0010961        ,0.00,8200000,22782240257.29,19082200109610000018,
3869,22/08/2019,10:37:05,22/08/2019,10:37:05,0247 UKT 1601618066 0819/0012490        ,0.00,1000000,22783240257.29,19082200124900000028,
3870,22/08/2019,10:37:39,22/08/2019,10:37:39,0247 UKT 1107618105 0819/0010519        ,0.00,3000000,22786240257.29,19082200105190000084,
3871,22/08/2019,10:38:50,22/08/2019,10:38:50,0247 UKT 1101618059 0819/0012490        ,0.00,1000000,22787240257.29,19082200124900000031,
3872,22/08/2019,10:42:15,22/08/2019,10:42:15,0247 UKT 1103618053 0819/0008219        ,0.00,5300000,22792540257.29,19082200082190000059,
3873,22/08/2019,10:43:21,22/08/2019,10:43:21,0247 UKT 1201617051 0819/0008219        ,0.00,6000000,22798540257.29,19082200082190000061,
3874,22/08/2019,10:43:56,22/08/2019,10:43:56,0247 UKT 1205618067 0819/0018015        ,0.00,3900000,22802440257.29,19082200180150000057,
3875,22/08/2019,10:44:16,22/08/2019,10:44:16,0247 UKT 1101618040 0819/0012934        ,0.00,500000,22802940257.29,19082200129340000007,
3876,22/08/2019,10:44:28,22/08/2019,10:44:28,0247 UKT 1301617077 0819/0011914        ,0.00,3800000,22806740257.29,19082200119140000002,
3877,22/08/2019,10:44:30,22/08/2019,10:44:30,0247 UKT 1601617199 0819/0008219        ,0.00,1000000,22807740257.29,19082200082190000063,
3878,22/08/2019,10:45:59,22/08/2019,10:45:59,0247 UKT 1208618047 0819/0013446        ,0.00,5200000,22812940257.29,19082200134460000044,
3879,22/08/2019,10:46:02,22/08/2019,10:46:02,0247 UKT 1801618034 0819/0008219        ,0.00,7200000,22820140257.29,19082200082190000065,
3880,22/08/2019,10:46:55,22/08/2019,10:46:55,0247 UKT                                ,0.00,5600000,22825740257.29,19082299211200182352,
3881,22/08/2019,10:47:58,22/08/2019,10:47:58,0247 UKT 1308617067 0819/0016991        ,0.00,5250000,22830990257.29,19082200169910000008,
3882,22/08/2019,10:49:41,22/08/2019,10:49:41,0247 UKT 1105617015 0819/0008594        ,0.00,6400000,22837390257.29,19082200085940000032,
3883,22/08/2019,10:49:49,22/08/2019,10:49:49,0247 UKT 1313618026 0819/0008573        ,0.00,6200000,22843590257.29,19082200085730000008,
3884,22/08/2019,10:51:10,22/08/2019,10:51:10,0247 UKT 1801617196 0819/0007901        ,0.00,4000000,22847590257.29,19082200079010000022,
3885,22/08/2019,10:52:09,22/08/2019,10:52:09,0247 UKT 1604618033 0819/0008594        ,0.00,4300000,22851890257.29,19082200085940000034,
3886,22/08/2019,10:53:21,22/08/2019,10:53:21,0247 UKT 1204618048 0819/0008219        ,0.00,6100000,22857990257.29,19082200082190000067,
3887,22/08/2019,10:54:57,22/08/2019,10:54:57,0247 UKT 1801618102 0819/0008561        ,0.00,7200000,22865190257.29,19082200085610000020,
3888,22/08/2019,10:55:39,22/08/2019,10:55:39,0247 UKT 1107618041 0819/0007901        ,0.00,3000000,22868190257.29,19082200079010000024,
3889,22/08/2019,10:57:09,22/08/2019,10:57:09,0247 UKT 1303618066 0819/0007754        ,0.00,1000000,22869190257.29,19082200077540000055,
3890,22/08/2019,10:57:12,22/08/2019,10:57:12,0247 UKT 1105617037 0819/0010423        ,0.00,1000000,22870190257.29,19082200104230000049,
3891,22/08/2019,10:57:28,22/08/2019,10:57:28,0247 UKT 1603618030 0819/0016631        ,0.00,3200000,22873390257.29,19082200166310000006,
3892,22/08/2019,11:00:06,22/08/2019,11:00:06,0247 UKT 1603617152 0819/0011952        ,0.00,500000,22873890257.29,19082200119520000007,
3893,22/08/2019,11:03:06,22/08/2019,11:03:06,0247 UKT 1105617047 0819/0013466        ,0.00,3000000,22876890257.29,19082200134660000011,
3894,22/08/2019,11:03:32,22/08/2019,11:03:32,0247 UKT 1107618150 0819/0018027        ,0.00,5100000,22881990257.29,19082200180270000012,
3895,22/08/2019,11:04:05,22/08/2019,11:04:05,0247 UKT 1107617251 0819/0017359        ,0.00,5100000,22887090257.29,19082200173590000013,
3896,22/08/2019,11:04:09,22/08/2019,11:04:09,0247 UKT 1107617144 0819/0012936        ,0.00,3900000,22890990257.29,19082200129360000008,
3897,22/08/2019,11:05:07,22/08/2019,11:05:07,0247 UKT 1107618063 0819/0007754        ,0.00,1000000,22891990257.29,19082200077540000058,
3898,22/08/2019,11:09:00,22/08/2019,11:09:00,0247 UKT 1107617160 0819/0012486        ,0.00,1000000,22892990257.29,19082200124860000021,
3899,22/08/2019,11:13:47,22/08/2019,11:13:47,0247 UKT 1103617025 0819/0007248        ,0.00,4700000,22897690257.29,19082200072480000014,
3900,22/08/2019,11:14:08,22/08/2019,11:14:08,0247 UKT 1603617130 0819/0008219        ,0.00,3200000,22900890257.29,19082200082190000069,
3901,22/08/2019,11:14:56,22/08/2019,11:14:56,0247 UKT 1104618010 0819/0008940        ,0.00,3000000,22903890257.29,19082200089400000031,
3902,22/08/2019,11:16:13,22/08/2019,11:16:13,0247 UKT 1211618019 0819/0008219        ,0.00,5600000,22909490257.29,19082200082190000071,
3903,22/08/2019,11:16:50,22/08/2019,11:16:50,0247 UKT 1105618074 0819/0005992        ,0.00,5100000,22914590257.29,19082200059920000006,
3904,22/08/2019,11:17:42,22/08/2019,11:17:42,0247 UKT 1211618025 0819/0008219        ,0.00,5600000,22920190257.29,19082200082190000073,
3905,22/08/2019,11:19:30,22/08/2019,11:19:30,0247 UKT 1203617007 0819/0008219        ,0.00,3700000,22923890257.29,19082200082190000075,
3906,22/08/2019,11:20:01,22/08/2019,11:20:01,0247 UKT 1107617265 0819/0016714        ,0.00,1000000,22924890257.29,19082200167140000030,
3907,22/08/2019,11:21:17,22/08/2019,11:21:17,0247 UKT 1202617053 0819/0010403        ,0.00,3900000,22928790257.29,19082200104030000055,
3908,22/08/2019,11:21:26,22/08/2019,11:21:26,0247 UKT 1101617115 0819/0007348        ,0.00,3000000,22931790257.29,19082200073480000025,
3909,22/08/2019,11:21:32,22/08/2019,11:21:32,0247 UKT 1313618031 0819/0008219        ,0.00,6200000,22937990257.29,19082200082190000077,
3910,22/08/2019,11:21:47,22/08/2019,11:21:47,0247 UKT 1103618078 0819/0007759        ,0.00,4000000,22941990257.29,19082200077590000048,
3911,22/08/2019,11:22:56,22/08/2019,11:22:56,0247 UKT 1304618073 0819/0016488        ,0.00,6200000,22948190257.29,19082200164880000035,
3912,22/08/2019,11:24:41,22/08/2019,11:24:41,0247 UKT 1207618039 0819/0017974        ,0.00,4500000,22952690257.29,19082200179740000040,
3913,22/08/2019,11:26:24,22/08/2019,11:26:24,0247 UKT 1107617243 0819/0006827        ,0.00,5100000,22957790257.29,19082200068270000042,
3914,22/08/2019,11:26:39,22/08/2019,11:26:39,0247 UKT 1102618075 0819/0008958        ,0.00,1000000,22958790257.29,19082200089580000007,
3915,22/08/2019,11:26:49,22/08/2019,11:26:49,0247 UKT 1305617022 0819/0013066        ,0.00,6200000,22964990257.29,19082200130660000017,
3916,22/08/2019,11:28:35,22/08/2019,11:28:35,0247 UKT 1305617020 0819/0016533        ,0.00,4000000,22968990257.29,19082200165330000037,
3917,22/08/2019,11:28:46,22/08/2019,11:28:46,0247 UKT 1211617054 0819/0008219        ,0.00,5600000,22974590257.29,19082200082190000080,
3918,22/08/2019,11:29:56,22/08/2019,11:29:56,0247 UKT 1105618021 0819/0009593        ,0.00,1000000,22975590257.29,19082200095930000049,
3919,22/08/2019,11:30:06,22/08/2019,11:30:06,0247 UKT 1801618065 0819/0016660        ,0.00,1000000,22976590257.29,19082200166600000008,
3920,22/08/2019,11:30:56,22/08/2019,11:30:56,0247 UKT 1301617042 0819/0008219        ,0.00,3800000,22980390257.29,19082200082190000082,
3921,22/08/2019,11:33:07,22/08/2019,11:33:07,0247 UKT 1211618006 0819/0008219        ,0.00,3700000,22984090257.29,19082200082190000084,
3922,22/08/2019,11:35:08,22/08/2019,11:35:08,0247 UKT 1601618039 0819/0017009        ,0.00,4700000,22988790257.29,19082200170090000053,
3923,22/08/2019,11:35:22,22/08/2019,11:35:22,0247 UKT 1209617043 0819/0008219        ,0.00,4500000,22993290257.29,19082200082190000086,
3924,22/08/2019,11:36:34,22/08/2019,11:36:34,0247 UKT 1105618076 0819/0008219        ,0.00,1000000,22994290257.29,19082200082190000088,
3925,22/08/2019,11:38:31,22/08/2019,11:38:31,0247 UKT 1107617152 0819/0008219        ,0.00,1000000,22995290257.29,19082200082190000092,
3926,22/08/2019,11:39:03,22/08/2019,11:39:03,0247 UKT 1107617151 0819/0016715        ,0.00,5100000,23000390257.29,19082200167150000017,
3927,22/08/2019,11:39:39,22/08/2019,11:39:39,0247 UKT 1314617036 0819/0008583        ,0.00,4000000,23004390257.29,19082200085830000036,
3928,22/08/2019,11:39:40,22/08/2019,11:39:40,0247 UKT 1104617021 0819/0017017        ,0.00,5300000,23009690257.29,19082200170170000022,
3929,22/08/2019,11:40:57,22/08/2019,11:40:57,0247 UKT 1313618017 0819/0010960        ,0.00,4000000,23013690257.29,19082200109600000018,
3930,22/08/2019,11:42:04,22/08/2019,11:42:04,0247 UKT 1201618039 0819/0008219        ,0.00,6000000,23019690257.29,19082200082190000094,
3931,22/08/2019,11:42:58,22/08/2019,11:42:58,0247 UKT 1101618078 0819/0010960        ,0.00,5300000,23024990257.29,19082200109600000020,
3932,22/08/2019,11:46:58,22/08/2019,11:46:58,0247 UKT 1201617072 0819/0016629        ,0.00,6400000,23031390257.29,19082200166290000025,
3933,22/08/2019,11:48:17,22/08/2019,11:48:17,0247 UKT 1801617244 0819/0013502        ,0.00,4000000,23035390257.29,19082200135020000009,
3934,22/08/2019,11:50:52,22/08/2019,11:50:52,0247 UKT 1602618055 0819/0010423        ,0.00,5400000,23040790257.29,19082200104230000055,
3935,22/08/2019,11:51:29,22/08/2019,11:51:29,0247 UKT 1102618021 0819/0016657        ,0.00,5100000,23045890257.29,19082200166570000054,
3936,22/08/2019,11:52:14,22/08/2019,11:52:14,0247 UKT 1206618017 0819/0008219        ,0.00,4500000,23050390257.29,19082200082190000096,
3937,22/08/2019,11:52:39,22/08/2019,11:52:39,0247 UKT 1104618016 0819/0013434        ,0.00,6472000,23056862257.29,19082200134340000013,
3938,22/08/2019,11:53:16,22/08/2019,11:53:16,0247 UKT 1102617068 0819/0016629        ,0.00,3000000,23059862257.29,19082200166290000027,
3939,22/08/2019,11:53:34,22/08/2019,11:53:34,0247 UKT 1304617008 0819/0008219        ,0.00,3950000,23063812257.29,19082200082190000098,
3940,22/08/2019,11:54:51,22/08/2019,11:54:51,0247 UKT 1604618042 0819/0016545        ,0.00,500000,23064312257.29,19082200165450000067,
3941,22/08/2019,11:55:28,22/08/2019,11:55:28,0247 UKT 1308617045 0819/0008219        ,0.00,4150000,23068462257.29,19082200082190000100,
3942,22/08/2019,11:59:10,22/08/2019,11:59:10,0247 UKT 1601618096 0819/0016490        ,0.00,4700000,23073162257.29,19082200164900000023,
3943,22/08/2019,11:59:23,22/08/2019,11:59:23,0247 UKT 1103617050 0819/0008244        ,0.00,5300000,23078462257.29,19082200082440000014,
3944,22/08/2019,12:01:01,22/08/2019,12:01:01,0247 UKT 1201617074 0819/0018000        ,0.00,4700000,23083162257.29,19082200180000000008,
3945,22/08/2019,12:03:11,22/08/2019,12:03:11,0247 UKT 1303618022 0819/0017012        ,0.00,3950000,23087112257.29,19082200170120000041,
3946,22/08/2019,12:05:08,22/08/2019,12:05:08,0247 UKT 1308617007 0819/0009761        ,0.00,4150000,23091262257.29,19082200097610000051,
3947,22/08/2019,12:07:07,22/08/2019,12:07:07,0247 UKT 1103617063 0819/0007770        ,0.00,5300000,23096562257.29,19082200077700000033,
3948,22/08/2019,12:10:18,22/08/2019,12:10:18,0247 UKT 1313617031 0819/0011952        ,0.00,1000000,23097562257.29,19082200119520000023,
3949,22/08/2019,12:12:56,22/08/2019,12:12:56,0247 UKT 1603618031 0819/0011831        ,0.00,3200000,23100762257.29,19082200118310000015,
3950,22/08/2019,12:14:00,22/08/2019,12:14:00,0247 UKT 1105618070 0819/0017963        ,0.00,3000000,23103762257.29,19082200179630000011,
3951,22/08/2019,12:16:57,22/08/2019,12:16:57,0247 UKT 1208617028 0819/0017980        ,0.00,4500000,23108262257.29,19082200179800000108,
3952,22/08/2019,12:20:06,22/08/2019,12:20:06,0247 UKT 1203618042 0819/0009659        ,0.00,5600000,23113862257.29,19082200096590000015,
3953,22/08/2019,12:22:38,22/08/2019,12:22:38,0247 UKT 1603617020 0819/0010758        ,0.00,1000000,23114862257.29,19082200107580000025,
3954,22/08/2019,12:23:09,22/08/2019,12:23:09,0247 UKT 1601618051 0819/0010977        ,0.00,5400000,23120262257.29,19082200109770000022,
3955,22/08/2019,12:24:43,22/08/2019,12:24:43,0247 UKT 1601618055 0819/0010977        ,0.00,4700000,23124962257.29,19082200109770000024,
3956,22/08/2019,12:24:51,22/08/2019,12:24:51,0247 UKT 1103618038 0819/0017346        ,0.00,1000000,23125962257.29,19082200173460000031,
3957,22/08/2019,12:37:40,22/08/2019,12:37:40,0247 UKT 1313617011 0819/0016491        ,0.00,4000000,23129962257.29,19082200164910000045,
3958,22/08/2019,12:38:17,22/08/2019,12:38:17,0247 UKT 1201617079 0819/0012477        ,0.00,4700000,23134662257.29,19082200124770000006,
3959,22/08/2019,12:45:01,22/08/2019,12:45:01,0247 UKT 1103617022 0819/0008561        ,0.00,3000000,23137662257.29,19082200085610000034,
3960,22/08/2019,12:47:35,22/08/2019,12:47:35,0247 UKT 1305618031 0819/0016435        ,0.00,5200000,23142862257.29,19082200164350000100,
3961,22/08/2019,12:57:42,22/08/2019,12:57:42,0247 UKT 1601618067 0819/0013080        ,0.00,4700000,23147562257.29,19082200130800000019,
3962,22/08/2019,12:58:09,22/08/2019,12:58:09,0247 UKT                                ,0.00,4000000,23151562257.29,19082299286010126810,
3963,22/08/2019,13:02:25,22/08/2019,13:02:25,0247 UKT 1107618159 0819/0008219        ,0.00,5100000,23156662257.29,19082200082190000103,
3964,22/08/2019,13:03:52,22/08/2019,13:03:52,0247 UKT 1204617029 0819/0008219        ,0.00,5900000,23162562257.29,19082200082190000105,
3965,22/08/2019,13:05:49,22/08/2019,13:05:49,0247 UKT 1205618012 0819/0008219        ,0.00,4500000,23167062257.29,19082200082190000107,
3966,22/08/2019,13:06:15,22/08/2019,13:06:15,0247 UKT 1204618030 0819/0008281        ,0.00,3900000,23170962257.29,19082200082810000032,
3967,22/08/2019,13:07:06,22/08/2019,13:07:06,0247 UKT 1601618097 0819/0018000        ,0.00,500000,23171462257.29,19082200180000000021,
3968,22/08/2019,13:07:07,22/08/2019,13:07:07,0247 UKT 1801618104 0819/0016653        ,0.00,8200000,23179662257.29,19082200166530000070,
3969,22/08/2019,13:08:00,22/08/2019,13:08:00,0247 UKT 1105617075 0819/0008219        ,0.00,5100000,23184762257.29,19082200082190000109,
3970,22/08/2019,13:09:08,22/08/2019,13:09:08,0247 UKT 1204618009 0819/0008219        ,0.00,4500000,23189262257.29,19082200082190000111,
3971,22/08/2019,13:09:41,22/08/2019,13:09:41,0247 UKT 1203617031 0819/0017969        ,0.00,500000,23189762257.29,19082200179690000014,
3972,22/08/2019,13:10:12,22/08/2019,13:10:12,0247 UKT 1302617016 0819/0008219        ,0.00,1000000,23190762257.29,19082200082190000113,
3973,22/08/2019,13:10:25,22/08/2019,13:10:25,0247 UKT 1601617087 0819/0013465        ,0.00,4700000,23195462257.29,19082200134650000074,
3974,22/08/2019,13:10:41,22/08/2019,13:10:41,0247 UKT 1602617182 0819/0017472        ,0.00,500000,23195962257.29,19082200174720000038,
3975,22/08/2019,13:11:09,22/08/2019,13:11:09,0247 UKT 1202617061 0819/0017999        ,0.00,5900000,23201862257.29,19082200179990000062,
3976,22/08/2019,13:11:10,22/08/2019,13:11:10,0247 UKT 1211617057 0819/0008219        ,0.00,6200000,23208062257.29,19082200082190000115,
3977,22/08/2019,13:11:50,22/08/2019,13:11:50,0247 UKT 1209617049 0819/0011932        ,0.00,6700000,23214762257.29,19082200119320000017,
3978,22/08/2019,13:13:29,22/08/2019,13:13:29,0247 UKT 1301617039 0819/0016689        ,0.00,3800000,23218562257.29,19082200166890000078,
3979,22/08/2019,13:15:19,22/08/2019,13:15:19,0247 UKT 1107618096 0819/0017977        ,0.00,5100000,23223662257.29,19082200179770000052,
3980,22/08/2019,13:15:43,22/08/2019,13:15:43,0247 UKT 1206618024 0819/0008219        ,0.00,5200000,23228862257.29,19082200082190000119,
3981,22/08/2019,13:17:18,22/08/2019,13:17:18,0247 UKT 1306617013 0819/0013080        ,0.00,4000000,23232862257.29,19082200130800000025,
3982,22/08/2019,13:17:45,22/08/2019,13:17:45,0247 UKT 1203617076 0819/0010977        ,0.00,3700000,23236562257.29,19082200109770000030,
3983,22/08/2019,13:19:22,22/08/2019,13:19:22,0247 UKT 1602617106 0819/0016486        ,0.00,2700000,23239262257.29,19082200164860000117,
3984,22/08/2019,13:19:41,22/08/2019,13:19:41,0247 UKT 1602618035 0819/0016674        ,0.00,2700000,23241962257.29,19082200166740000055,
3985,22/08/2019,13:21:43,22/08/2019,13:21:43,0247 UKT 1307617026 0819/0018029        ,0.00,6250000,23248212257.29,19082200180290000014,
3986,22/08/2019,13:21:58,22/08/2019,13:21:58,0247 UKT                                ,0.00,6000000,23254212257.29,19082299275010293165,
3987,22/08/2019,13:24:41,22/08/2019,13:24:41,0247 UKT 1603617055 0819/0008594        ,0.00,6500000,23260712257.29,19082200085940000039,
3988,22/08/2019,13:25:46,22/08/2019,13:25:46,0247 UKT 1308617071 0819/0016708        ,0.00,4150000,23264862257.29,19082200167080000030,
3989,22/08/2019,13:26:32,22/08/2019,13:26:32,0247 UKT 1210618032 0819/0008219        ,0.00,1000000,23265862257.29,19082200082190000124,
3990,22/08/2019,13:27:14,22/08/2019,13:27:14,0247 UKT 1106618081 0819/0008555        ,0.00,6400000,23272262257.29,19082200085550000024,
3991,22/08/2019,13:27:19,22/08/2019,13:27:19,0247 UKT 1104618036 0819/0013467        ,0.00,5300000,23277562257.29,19082200134670000009,
3992,22/08/2019,13:27:52,22/08/2019,13:27:52,0247 UKT 1203617067 0819/0008561        ,0.00,5600000,23283162257.29,19082200085610000036,
3993,22/08/2019,13:29:05,22/08/2019,13:29:05,0247 UKT 1105617060 0819/0008219        ,0.00,5100000,23288262257.29,19082200082190000126,
3994,22/08/2019,13:30:03,22/08/2019,13:30:03,0247 UKT 1201617057 0819/0008219        ,0.00,1000000,23289262257.29,19082200082190000128,
3995,22/08/2019,13:30:09,22/08/2019,13:30:09,0247 UKT                                ,0.00,10300000,23299562257.29,19082299291010351871,
3996,22/08/2019,13:31:24,22/08/2019,13:31:24,0247 UKT 1103617054 0819/0007367        ,0.00,3000000,23302562257.29,19082200073670000133,
3997,22/08/2019,13:31:48,22/08/2019,13:31:48,0247 UKT 1211617033 0819/0011540        ,0.00,5600000,23308162257.29,19082200115400000021,
3998,22/08/2019,13:32:17,22/08/2019,13:32:17,0247 UKT 1103617108 0819/0017008        ,0.00,4000000,23312162257.29,19082200170080000039,
3999,22/08/2019,13:32:25,22/08/2019,13:32:25,0247 UKT 1601617201 0819/0012923        ,0.00,500000,23312662257.29,19082200129230000069,
4000,22/08/2019,13:32:48,22/08/2019,13:32:48,0247 UKT 1605618017 0819/0016437        ,0.00,6500000,23319162257.29,19082200164370000023,
4001,22/08/2019,13:32:56,22/08/2019,13:32:56,0247 UKT 1603617036 0819/0009764        ,0.00,3200000,23322362257.29,19082200097640000004,
4002,22/08/2019,13:33:09,22/08/2019,13:33:09,0247 UKT 1107618081 0819/0008550        ,0.00,3000000,23325362257.29,19082200085500000011,
4003,22/08/2019,13:33:14,22/08/2019,13:33:14,0247 UKT 1303618070 0819/0013785        ,0.00,9000000,23334362257.29,19082200137850000091,
4004,22/08/2019,13:33:55,22/08/2019,13:33:55,0247 UKT 1107617220 0819/0007348        ,0.00,3000000,23337362257.29,19082200073480000041,
4005,22/08/2019,13:34:22,22/08/2019,13:34:22,0247 UKT 1602618009 0819/0008207        ,0.00,3400000,23340762257.29,19082200082070000097,
4006,22/08/2019,13:34:37,22/08/2019,13:34:37,0247 UKT 1602617151 0819/0008594        ,0.00,500000,23341262257.29,19082200085940000041,
4007,22/08/2019,13:35:05,22/08/2019,13:35:05,0247 UKT 1603617103 0819/0016525        ,0.00,6500000,23347762257.29,19082200165250000029,
4008,22/08/2019,13:35:36,22/08/2019,13:35:36,0247 UKT 1603617099 0819/0009764        ,0.00,7600000,23355362257.29,19082200097640000006,
4009,22/08/2019,13:35:54,22/08/2019,13:35:54,0247 UKT 1101618080 0819/0016437        ,0.00,5300000,23360662257.29,19082200164370000025,
4010,22/08/2019,13:37:02,22/08/2019,13:37:02,0247 UKT 1208618002 0819/0008219        ,0.00,500000,23361162257.29,19082200082190000133,
4011,22/08/2019,13:37:29,22/08/2019,13:37:29,0247 UKT 1306617009 0819/0012234        ,0.00,4000000,23365162257.29,19082200122340000046,
4012,22/08/2019,13:40:10,22/08/2019,13:40:10,0247 UKT                                ,0.00,3700000,23368862257.29,19082299369010427655,
4013,22/08/2019,13:41:18,22/08/2019,13:41:18,0247 UKT 1308618049 0819/0008219        ,0.00,4150000,23373012257.29,19082200082190000135,
4014,22/08/2019,13:41:58,22/08/2019,13:41:58,0247 UKT 1601618087 0819/0012882        ,0.00,4700000,23377712257.29,19082200128820000036,
4015,22/08/2019,13:43:52,22/08/2019,13:43:52,0247 UKT 1207618049 0819/0008219        ,0.00,1000000,23378712257.29,19082200082190000137,
4016,22/08/2019,13:44:55,22/08/2019,13:44:55,0247 UKT 1101617083 0819/0008219        ,0.00,5300000,23384012257.29,19082200082190000139,
4017,22/08/2019,13:45:20,22/08/2019,13:45:20,0247 UKT 1601618057 0819/0008594        ,0.00,4900000,23388912257.29,19082200085940000045,
4018,22/08/2019,13:46:30,22/08/2019,13:46:30,0247 UKT 1105617070 0819/0013469        ,0.00,3900000,23392812257.29,19082200134690000027,
4019,22/08/2019,13:47:19,22/08/2019,13:47:19,0247 UKT 1601617076 0819/0018000        ,0.00,2700000,23395512257.29,19082200180000000023,
4020,22/08/2019,13:47:29,22/08/2019,13:47:29,0247 UKT 1205618024 0819/0008219        ,0.00,3900000,23399412257.29,19082200082190000142,
4021,22/08/2019,13:50:03,22/08/2019,13:50:03,0247 UKT 1306618036 0819/0008219        ,0.00,5200000,23404612257.29,19082200082190000144,
4022,22/08/2019,13:51:01,22/08/2019,13:51:01,0247 UKT 1211617037 0819/0008219        ,0.00,3700000,23408312257.29,19082200082190000146,
4023,22/08/2019,13:51:03,22/08/2019,13:51:03,0247 UKT 1313617032 0819/0009757        ,0.00,6200000,23414512257.29,19082200097570000024,
4024,22/08/2019,13:51:10,22/08/2019,13:51:10,0247 UKT 1603617085 0819/0008289        ,0.00,8600000,23423112257.29,19082200082890000066,
4025,22/08/2019,13:51:19,22/08/2019,13:51:19,0247 UKT 1601617023 0819/0008594        ,0.00,4700000,23427812257.29,19082200085940000049,
4026,22/08/2019,13:51:36,22/08/2019,13:51:36,0247 UKT 1801618158 0819/0010530        ,0.00,8200000,23436012257.29,19082200105300000043,
4027,22/08/2019,13:52:29,22/08/2019,13:52:29,0247 UKT 1101617068 0819/0008175        ,0.00,6000000,23442012257.29,19082200081750000012,
4028,22/08/2019,13:52:53,22/08/2019,13:52:53,0247 UKT 1103618066 0819/0010941        ,0.00,1000000,23443012257.29,19082200109410000035,
4029,22/08/2019,13:53:01,22/08/2019,13:53:01,0247 UKT 1601618071 0819/0008594        ,0.00,2700000,23445712257.29,19082200085940000051,
4030,22/08/2019,14:00:09,22/08/2019,14:00:09,0247 UKT 1209618026 0819/0011939        ,0.00,6700000,23452412257.29,19082200119390000032,
4031,22/08/2019,14:00:41,22/08/2019,14:00:41,0247 UKT 1602617103 0819/0018000        ,0.00,3400000,23455812257.29,19082200180000000032,
4032,22/08/2019,14:02:30,22/08/2019,14:02:30,0247 UKT 1602618071 0819/0018000        ,0.00,2700000,23458512257.29,19082200180000000034,
4033,22/08/2019,14:02:56,22/08/2019,14:02:56,0247 UKT 1602617073 0819/0013056        ,0.00,4700000,23463212257.29,19082200130560000044,
4034,22/08/2019,14:03:16,22/08/2019,14:03:16,0247 UKT 1801617194 0819/0009627        ,0.00,8200000,23471412257.29,19082200096270000038,
4035,22/08/2019,14:05:55,22/08/2019,14:05:55,0247 UKT 1604618032 0819/0012479        ,0.00,3200000,23474612257.29,19082200124790000013,
4036,22/08/2019,14:05:58,22/08/2019,14:05:58,0247 UKT 1203618030 0819/0008552        ,0.00,3700000,23478312257.29,19082200085520000076,
4037,22/08/2019,14:07:37,22/08/2019,14:07:37,0247 UKT 1205617055 0819/0011952        ,0.00,4500000,23482812257.29,19082200119520000040,
4038,22/08/2019,14:07:43,22/08/2019,14:07:43,0247 UKT 1210617032 0819/0012234        ,0.00,7700000,23490512257.29,19082200122340000052,
4039,22/08/2019,14:08:01,22/08/2019,14:08:01,0247 UKT 1603618020 0819/0012490        ,0.00,6500000,23497012257.29,19082200124900000075,
4040,22/08/2019,14:08:48,22/08/2019,14:08:48,0247 UKT 1103617111 0819/0008588        ,0.00,5300000,23502312257.29,19082200085880000040,
4041,22/08/2019,14:09:23,22/08/2019,14:09:23,0247 UKT 1104617114 0819/0013825        ,0.00,6700000,23509012257.29,19082200138250000086,
4042,22/08/2019,14:10:43,22/08/2019,14:10:43,0247 UKT 1102618041 0819/0009757        ,0.00,3000000,23512012257.29,19082200097570000026,
4043,22/08/2019,14:13:21,22/08/2019,14:13:21,0247 UKT 1206617050 0819/0008219        ,0.00,4500000,23516512257.29,19082200082190000156,
4044,22/08/2019,14:13:39,22/08/2019,14:13:39,0247 UKT 1314617024 0819/0005992        ,0.00,8300000,23524812257.29,19082200059920000015,
4045,22/08/2019,14:15:11,22/08/2019,14:15:11,0247 UKT 1603618042 0819/0008219        ,0.00,1000000,23525812257.29,19082200082190000158,
4046,22/08/2019,14:15:35,22/08/2019,14:15:35,0247 UKT 1602617131 0819/0012489        ,0.00,500000,23526312257.29,19082200124890000066,
4047,22/08/2019,14:15:52,22/08/2019,14:15:52,0247 UKT 1207617011 0819/0017989        ,0.00,5900000,23532212257.29,19082200179890000045,
4048,22/08/2019,14:15:53,22/08/2019,14:15:53,0247 UKT 1107617264 0819/0016657        ,0.00,4500000,23536712257.29,19082200166570000063,
4049,22/08/2019,14:16:15,22/08/2019,14:16:15,0247 UKT 1105617071 0819/0016716        ,0.00,3000000,23539712257.29,19082200167160000046,
4050,22/08/2019,14:17:30,22/08/2019,14:17:30,0247 UKT 1104618013 0819/0008219        ,0.00,4000000,23543712257.29,19082200082190000160,
4051,22/08/2019,14:17:31,22/08/2019,14:17:31,0247 UKT 1303618044 0819/0017996        ,0.00,3950000,23547662257.29,19082200179960000098,
4052,22/08/2019,14:17:59,22/08/2019,14:17:59,0247 UKT 1603618028 0819/0011932        ,0.00,4300000,23551962257.29,19082200119320000029,
4053,22/08/2019,14:19:00,22/08/2019,14:19:00,0247 UKT 1206617007 0819/0008219        ,0.00,4500000,23556462257.29,19082200082190000162,
4054,22/08/2019,14:19:13,22/08/2019,14:19:13,0247 UKT                                ,0.00,3700000,23560162257.29,19082299101210701848,
4055,22/08/2019,14:20:45,22/08/2019,14:20:45,0247 UKT 1205617117 0819/0008219        ,0.00,5900000,23566062257.29,19082200082190000164,
4056,22/08/2019,14:21:45,22/08/2019,14:21:45,0247 UKT 1602617183 0819/0167038        ,0.00,500000,23566562257.29,19082201670380000134,
4057,22/08/2019,14:21:53,22/08/2019,14:21:53,0247 UKT 1301617037 0819/0009593        ,0.00,7000000,23573562257.29,19082200095930000133,
4058,22/08/2019,14:21:54,22/08/2019,14:21:54,0247 UKT 1102617094 0819/0008555        ,0.00,1000000,23574562257.29,19082200085550000026,
4059,22/08/2019,14:22:04,22/08/2019,14:22:04,0247 UKT 1101617074 0819/0010443        ,0.00,5300000,23579862257.29,19082200104430000202,
4060,22/08/2019,14:22:20,22/08/2019,14:22:20,0247 UKT 1301617067 0819/0016990        ,0.00,6000000,23585862257.29,19082200169900000075,
4061,22/08/2019,14:22:46,22/08/2019,14:22:46,0247 UKT 1107617039 0819/0008219        ,0.00,1000000,23586862257.29,19082200082190000166,
4062,22/08/2019,14:23:25,22/08/2019,14:23:25,0247 UKT 1208618062 0819/0013446        ,0.00,6700000,23593562257.29,19082200134460000062,
4063,22/08/2019,14:23:44,22/08/2019,14:23:44,0247 UKT 1307617024 0819/0012492        ,0.00,6250000,23599812257.29,19082200124920000046,
4064,22/08/2019,14:23:57,22/08/2019,14:23:57,0247 UKT 1313618034 0819/0009574        ,0.00,6200000,23606012257.29,19082200095740000051,
4065,22/08/2019,14:24:32,22/08/2019,14:24:32,0247 UKT 1105618020 0819/0017980        ,0.00,3900000,23609912257.29,19082200179800000134,
4066,22/08/2019,14:25:26,22/08/2019,14:25:26,0247 UKT 1801617289 0819/0010956        ,0.00,4000000,23613912257.29,19082200109560000110,
4067,22/08/2019,14:25:30,22/08/2019,14:25:30,0247 UKT 1210617014 0819/0008586        ,0.00,4600000,23618512257.29,19082200085860000028,
4068,22/08/2019,14:25:40,22/08/2019,14:25:40,0247 UKT 1206618015 0819/0006645        ,0.00,4500000,23623012257.29,19082200066450000120,
4069,22/08/2019,14:26:08,22/08/2019,14:26:08,0247 UKT 1201618054 0819/0008219        ,0.00,6000000,23629012257.29,19082200082190000168,
4070,22/08/2019,14:27:27,22/08/2019,14:27:27,0247 UKT 1102617062 0819/0010443        ,0.00,3000000,23632012257.29,19082200104430000208,
4071,22/08/2019,14:28:17,22/08/2019,14:28:17,0247 UKT 1303618020 0819/0008219        ,0.00,3950000,23635962257.29,19082200082190000170,
4072,22/08/2019,14:29:36,22/08/2019,14:29:36,0247 UKT 1101617047 0819/0009746        ,0.00,5300000,23641262257.29,19082200097460000021,
4073,22/08/2019,14:29:56,22/08/2019,14:29:56,0247 UKT 1801617302 0819/0013084        ,0.00,4000000,23645262257.29,19082200130840000042,
4074,22/08/2019,14:30:32,22/08/2019,14:30:32,0247 UKT 1202617037 0819/0008219        ,0.00,500000,23645762257.29,19082200082190000174,
4075,22/08/2019,14:30:46,22/08/2019,14:30:46,0247 UKT 1103617114 0819/0012936        ,0.00,4700000,23650462257.29,19082200129360000042,
4076,22/08/2019,14:31:07,22/08/2019,14:31:07,0247 UKT 1801617186 0819/0007348        ,0.00,7200000,23657662257.29,19082200073480000045,
4077,22/08/2019,14:31:12,22/08/2019,14:31:12,0247 UKT 1104617047 0819/0012245        ,0.00,3000000,23660662257.29,19082200122450000067,
4078,22/08/2019,14:32:30,22/08/2019,14:32:30,0247 UKT 1603617140 0819/0007357        ,0.00,3200000,23663862257.29,19082200073570000041,
4079,22/08/2019,14:34:24,22/08/2019,14:34:24,0247 UKT 1602617029 0819/0008574        ,0.00,4000000,23667862257.29,19082200085740000064,
4080,22/08/2019,14:34:40,22/08/2019,14:34:40,0247 UKT 1102617086 0819/0010443        ,0.00,3900000,23671762257.29,19082200104430000210,
4081,22/08/2019,14:35:30,22/08/2019,14:35:30,0247 UKT 1204617030 0819/0011549        ,0.00,5200000,23676962257.29,19082200115490000018,
4082,22/08/2019,14:36:09,22/08/2019,14:36:09,0247 UKT 1601618053 0819/0008219        ,0.00,1000000,23677962257.29,19082200082190000176,
4083,22/08/2019,14:36:20,22/08/2019,14:36:20,0247 UKT 1103617080 0819/0013446        ,0.00,3000000,23680962257.29,19082200134460000066,
4084,22/08/2019,14:37:57,22/08/2019,14:37:57,0247 UKT 1208618059 0819/0008219        ,0.00,4500000,23685462257.29,19082200082190000178,
4085,22/08/2019,14:37:59,22/08/2019,14:37:59,0247 UKT 1103617107 0819/0017989        ,0.00,6000000,23691462257.29,19082200179890000047,
4086,22/08/2019,14:40:52,22/08/2019,14:40:52,0247 UKT 1603617102 0819/0013439        ,0.00,8600000,23700062257.29,19082200134390000064,
4087,22/08/2019,14:42:51,22/08/2019,14:42:51,0247 UKT 1604618040 0819/0009627        ,0.00,4800000,23704862257.29,19082200096270000040,
4088,22/08/2019,14:46:11,22/08/2019,14:46:11,0247 UKT 1209617041 0819/0012491        ,0.00,4500000,23709362257.29,19082200124910000049,
4089,22/08/2019,14:46:39,22/08/2019,14:46:39,0247 UKT 1203617081 0819/0008219        ,0.00,500000,23709862257.29,19082200082190000184,
4090,22/08/2019,14:47:12,22/08/2019,14:47:12,0247 UKT 1602618013 0819/0013785        ,0.00,5400000,23715262257.29,19082200137850000119,
4091,22/08/2019,14:53:03,22/08/2019,14:53:03,0247 UKT 1303618052 0819/0008940        ,0.00,3950000,23719212257.29,19082200089400000078,
4092,22/08/2019,14:56:34,22/08/2019,14:56:34,0247 UKT 1101617032 0819/0009659        ,0.00,4000000,23723212257.29,19082200096590000028,
4093,22/08/2019,14:57:06,22/08/2019,14:57:06,0247 UKT 1602617137 0819/0013765        ,0.00,4700000,23727912257.29,19082200137650000054,
4094,22/08/2019,14:57:56,22/08/2019,14:57:56,0247 UKT 1107618045 0819/0016631        ,0.00,5100000,23733012257.29,19082200166310000014,
4095,22/08/2019,15:00:54,22/08/2019,15:00:54,0247 UKT 1603618009 0819/0018024        ,0.00,6500000,23739512257.29,19082200180240000029,
4096,22/08/2019,15:12:57,22/08/2019,15:12:57,0247 UKT                                ,0.00,1000000,23740512257.29,19082299410010069910,
4097,22/08/2019,15:18:30,22/08/2019,15:18:30,0247 UKT 1107617250 0819/0018010        ,0.00,1000000,23741512257.29,19082200180100000052,
4098,22/08/2019,15:19:26,22/08/2019,15:19:26,0247 UKT 1104617031 0819/0017481        ,0.00,3000000,23744512257.29,19082200174810000013,
4099,22/08/2019,15:21:05,22/08/2019,15:21:05,0247 UKT 1107618106 0819/0008219        ,0.00,500000,23745012257.29,19082200082190000196,
4100,22/08/2019,15:23:13,22/08/2019,15:23:13,0247 UKT 1105617025 0819/0008219        ,0.00,500000,23745512257.29,19082200082190000198,
4101,22/08/2019,15:26:00,22/08/2019,15:26:00,0247 UKT 1602618024 0819/0008219        ,0.00,3400000,23748912257.29,19082200082190000200,
4102,22/08/2019,15:28:01,22/08/2019,15:28:01,0247 UKT 1211618028 0819/0008219        ,0.00,5600000,23754512257.29,19082200082190000202,
4103,22/08/2019,16:35:05,22/08/2019,16:35:05,0247 UKT                                ,0.00,6200000,23760712257.29,19082299113810696713,
4104,22/08/2019,17:43:57,22/08/2019,17:43:57,0247 UKT                                ,0.00,5600000,23766312257.29,19082299113810178125,
4105,22/08/2019,17:48:04,22/08/2019,17:48:04,0247 UKT                                ,0.00,5800000,23772112257.29,19082299293010204410,
4106,22/08/2019,18:03:17,22/08/2019,18:03:17,0247 UKT                                ,0.00,6700000,23778812257.29,19082299113810301667,
4107,22/08/2019,18:36:23,22/08/2019,18:36:23,0247 UKT                                ,0.00,5200000,23784012257.29,19082299413010515329,
4108,22/08/2019,18:52:57,22/08/2019,18:52:57,0247 UKT                                ,0.00,6100000,23790112257.29,19082299200010634812,
4109,22/08/2019,18:54:50,22/08/2019,18:54:50,0247 UKT                                ,0.00,2700000,23792812257.29,19082299409010647692,
4110,22/08/2019,19:29:07,22/08/2019,19:29:07,0247 UKT                                ,0.00,6700000,23799512257.29,19082299211260879325,
4111,22/08/2019,19:51:32,22/08/2019,19:51:32,0247 UKT                                ,0.00,6700000,23806212257.29,19082299319010034680,
4112,22/08/2019,21:37:54,22/08/2019,21:37:54,0247 UKT                                ,0.00,5200000,23811412257.29,19082299332010641985,
4113,22/08/2019,22:05:55,22/08/2019,22:05:55,0247 UKT                                ,0.00,6200000,23817612257.29,19082299205010765748,
4114,23/08/2019,06:15:16,23/08/2019,06:15:16,0247 UKT                                ,0.00,6100000,23823712257.29,19082399113810384343,
4115,23/08/2019,08:12:18,23/08/2019,08:12:18,0247 UKT 1306617033 0819/0012491        ,0.00,5200000,23828912257.29,19082300124910000002,
4116,23/08/2019,08:14:28,23/08/2019,08:14:28,0247 UKT 1305618020 0819/0018019        ,0.00,5200000,23834112257.29,19082300180190000002,
4117,23/08/2019,08:16:59,23/08/2019,08:16:59,0247 UKT                                ,0.00,6200000,23840312257.29,19082399113810214280,
4118,23/08/2019,08:19:03,23/08/2019,08:19:03,0247 UKT 1939219011268 0819/0008219     ,0.00,6202000,23846514257.29,19082300082190000002,
4119,23/08/2019,08:20:32,23/08/2019,08:20:32,0247 UKT 1208618007 0819/0008586        ,0.00,4500000,23851014257.29,19082300085860000002,
4120,23/08/2019,08:20:50,23/08/2019,08:20:50,0247 UKT 1107617178 0819/0017789        ,0.00,4500000,23855514257.29,19082300177890000004,
4121,23/08/2019,08:21:29,23/08/2019,08:21:29,0247 UKT 1105617063 0819/0017756        ,0.00,3000000,23858514257.29,19082300177560000002,
4122,23/08/2019,08:22:30,23/08/2019,08:22:30,0247 UKT 1304617073 0819/0017789        ,0.00,3950000,23862464257.29,19082300177890000006,
4123,23/08/2019,08:22:32,23/08/2019,08:22:32,0247 UKT 1206618023 0819/0009746        ,0.00,6700000,23869164257.29,19082300097460000002,
4124,23/08/2019,08:22:47,23/08/2019,08:22:47,0247 UKT 1103617065 0819/0010947        ,0.00,4000000,23873164257.29,19082300109470000008,
4125,23/08/2019,08:25:23,23/08/2019,08:25:23,0247 UKT 1307618021 0819/0017983        ,0.00,4150000,23877314257.29,19082300179830000003,
4126,23/08/2019,08:26:03,23/08/2019,08:26:03,0247 UKT 1302618008 0819/0016719        ,0.00,3800000,23881114257.29,19082300167190000004,
4127,23/08/2019,08:26:29,23/08/2019,08:26:29,0247 UKT 1801617195 0819/0008251        ,0.00,7200000,23888314257.29,19082300082510000005,
4128,23/08/2019,08:27:20,23/08/2019,08:27:20,0247 UKT 1208618006 0819/0006645        ,0.00,500000,23888814257.29,19082300066450000009,
4129,23/08/2019,08:29:20,23/08/2019,08:29:20,0247 UKT                                ,0.00,5000000,23893814257.29,19082399113810316058,
4130,23/08/2019,08:33:26,23/08/2019,08:33:26,0247 UKT 1101617076 0819/0018015        ,0.00,3000000,23896814257.29,19082300180150000003,
4131,23/08/2019,08:33:57,23/08/2019,08:33:57,0247 UKT 1107618085 0819/0012490        ,0.00,3000000,23899814257.29,19082300124900000005,
4132,23/08/2019,08:34:38,23/08/2019,08:34:38,0247 UKT 1602617123 0819/0010956        ,0.00,2700000,23902514257.29,19082300109560000020,
4133,23/08/2019,08:35:20,23/08/2019,08:35:20,0247 UKT 1303618018 0819/0006789        ,0.00,5200000,23907714257.29,19082300067890000006,
4134,23/08/2019,08:43:15,23/08/2019,08:43:15,0247 UKT 1205617076 0819/0008219        ,0.00,6100000,23913814257.29,19082300082190000008,
4135,23/08/2019,08:44:16,23/08/2019,08:44:16,0247 UKT 1104617032 0819/0009766        ,0.00,6000000,23919814257.29,19082300097660000009,
4136,23/08/2019,08:44:53,23/08/2019,08:44:53,0247 UKT 1306618003 0819/0008219        ,0.00,1000000,23920814257.29,19082300082190000010,
4137,23/08/2019,08:45:32,23/08/2019,08:45:32,0247 UKT 1107618087 0819/0011965        ,0.00,3900000,23924714257.29,19082300119650000009,
4138,23/08/2019,08:46:38,23/08/2019,08:46:38,0247 UKT 1603618035 0819/0017009        ,0.00,7600000,23932314257.29,19082300170090000004,
4139,23/08/2019,08:49:19,23/08/2019,08:49:19,0247 UKT                                ,0.00,3900000,23936214257.29,19082399113810482615,
4140,23/08/2019,08:52:18,23/08/2019,08:52:18,0247 UKT                                ,0.00,3900000,23940114257.29,19082399113810507704,
4141,23/08/2019,08:52:34,23/08/2019,08:52:34,0247 UKT 1203617032 0819/0009574        ,0.00,3700000,23943814257.29,19082300095740000017,
4142,23/08/2019,08:53:53,23/08/2019,08:53:53,0247 UKT 1103617106 0819/0016990        ,0.00,4700000,23948514257.29,19082300169900000009,
4143,23/08/2019,08:54:34,23/08/2019,08:54:34,0247 UKT 1103617019 0819/0016412        ,0.00,4000000,23952514257.29,19082300164120000013,
4144,23/08/2019,08:56:37,23/08/2019,08:56:37,0247 UKT 1102617069 0819/0009746        ,0.00,5100000,23957614257.29,19082300097460000007,
4145,23/08/2019,09:00:05,23/08/2019,09:00:05,0247 UKT 1206617035 0819/0007248        ,0.00,4500000,23962114257.29,19082300072480000002,
4146,23/08/2019,09:01:42,23/08/2019,09:01:42,0247 UKT 1801618134 0819/0016435        ,0.00,6200000,23968314257.29,19082300164350000027,
4147,23/08/2019,09:03:05,23/08/2019,09:03:05,0247 UKT 1201617009 0819/0008219        ,0.00,4000000,23972314257.29,19082300082190000012,
4148,23/08/2019,09:03:32,23/08/2019,09:03:32,0247 UKT 1603617032 0819/0008555        ,0.00,3200000,23975514257.29,19082300085550000002,
4149,23/08/2019,09:03:46,23/08/2019,09:03:46,0247 UKT 1601617037 0819/0013762        ,0.00,1000000,23976514257.29,19082300137620000006,
4150,23/08/2019,09:04:49,23/08/2019,09:04:49,0247 UKT 1306617029 0819/0008225        ,0.00,4000000,23980514257.29,19082300082250000017,
4151,23/08/2019,09:04:56,23/08/2019,09:04:56,0247 UKT 1201617078 0819/0018233        ,0.00,4700000,23985214257.29,19082300182330000011,
4152,23/08/2019,09:07:27,23/08/2019,09:07:27,0247 UKT 1204617023 0819/0016671        ,0.00,3900000,23989114257.29,19082300166710000010,
4153,23/08/2019,09:07:28,23/08/2019,09:07:28,0247 UKT 1801617250 0819/0016658        ,0.00,4000000,23993114257.29,19082300166580000007,
4154,23/08/2019,09:10:06,23/08/2019,09:10:06,0247 UKT 1103617076 0819/0009704        ,0.00,3000000,23996114257.29,19082300097040000020,
4155,23/08/2019,09:10:06,23/08/2019,09:10:06,0247 UKT 1101617072 0819/0008219        ,0.00,5300000,24001414257.29,19082300082190000017,
4156,23/08/2019,09:12:43,23/08/2019,09:12:43,0247 UKT 1208618049 0819/0008219        ,0.00,6700000,24008114257.29,19082300082190000020,
4157,23/08/2019,09:14:24,23/08/2019,09:14:24,0247 UKT 1105617035 0819/0008219        ,0.00,3000000,24011114257.29,19082300082190000022,
4158,23/08/2019,09:14:28,23/08/2019,09:14:28,0247 UKT                                ,0.00,6200000,24017314257.29,19082399589010709064,
4159,23/08/2019,09:18:54,23/08/2019,09:18:54,0247 UKT 1201617040 0819/0008264        ,0.00,6000000,24023314257.29,19082300082640000023,
4160,23/08/2019,09:18:56,23/08/2019,09:18:56,0247 UKT 1601618085 0819/0010932        ,0.00,4700000,24028014257.29,19082300109320000005,
4161,23/08/2019,09:19:01,23/08/2019,09:19:01,0247 UKT 1205618068 0819/0008219        ,0.00,1000000,24029014257.29,19082300082190000024,
4162,23/08/2019,09:19:40,23/08/2019,09:19:40,0247 UKT 1301618028 0819/0009627        ,0.00,6000000,24035014257.29,19082300096270000017,
4163,23/08/2019,09:20:22,23/08/2019,09:20:22,0247 UKT 1204618031 0819/0008246        ,0.00,3900000,24038914257.29,19082300082460000030,
4164,23/08/2019,09:21:19,23/08/2019,09:21:19,0247 UKT 1603618015 0819/0008219        ,0.00,6500000,24045414257.29,19082300082190000026,
4165,23/08/2019,09:23:44,23/08/2019,09:23:44,0247 UKT 1209618024 0819/0008219        ,0.00,1000000,24046414257.29,19082300082190000028,
4166,23/08/2019,09:24:15,23/08/2019,09:24:15,0247 UKT 1101618047 0819/0012946        ,0.00,6700000,24053114257.29,19082300129460000009,
4167,23/08/2019,09:24:38,23/08/2019,09:24:38,0247 UKT 1603617089 0819/0017016        ,0.00,6500000,24059614257.29,19082300170160000038,
4168,23/08/2019,09:26:09,23/08/2019,09:26:09,0247 UKT 1314617003 0819/0012479        ,0.00,6400000,24066014257.29,19082300124790000008,
4169,23/08/2019,09:26:27,23/08/2019,09:26:27,0247 UKT 1107617202 0819/0010758        ,0.00,3000000,24069014257.29,19082300107580000004,
4170,23/08/2019,09:26:31,23/08/2019,09:26:31,0247 UKT 1105617043 0819/0008220        ,0.00,3900000,24072914257.29,19082300082200000004,
4171,23/08/2019,09:27:56,23/08/2019,09:27:56,0247 UKT 1103618051 0819/0018015        ,0.00,1000000,24073914257.29,19082300180150000005,
4172,23/08/2019,09:28:34,23/08/2019,09:28:34,0247 UKT                                ,0.00,5200000,24079114257.29,19082399140010833245,
4173,23/08/2019,09:28:35,23/08/2019,09:28:35,0247 UKT 1210618046 0819/0008294        ,0.00,1000000,24080114257.29,19082300082940000047,
4174,23/08/2019,09:29:45,23/08/2019,09:29:45,0247 UKT                                ,0.00,6700000,24086814257.29,19082399113810842258,
4175,23/08/2019,09:29:48,23/08/2019,09:29:48,0247 UKT 1209618025 0819/0017012        ,0.00,5900000,24092714257.29,19082300170120000007,
4176,23/08/2019,09:30:51,23/08/2019,09:30:51,0247 UKT 1107617256 0819/0009558        ,0.00,4500000,24097214257.29,19082300095580000013,
4177,23/08/2019,09:30:55,23/08/2019,09:30:55,0247 UKT 1205618057 0819/0013465        ,0.00,5900000,24103114257.29,19082300134650000064,
4178,23/08/2019,09:31:57,23/08/2019,09:31:57,0247 UKT 1603617117 0819/0008264        ,0.00,1000000,24104114257.29,19082300082640000028,
4179,23/08/2019,09:32:15,23/08/2019,09:32:15,0247 UKT 1103617009 0819/0016660        ,0.00,6000000,24110114257.29,19082300166600000004,
4180,23/08/2019,09:32:39,23/08/2019,09:32:39,0247 UKT 1107617176 0819/0010956        ,0.00,5100000,24115214257.29,19082300109560000050,
4181,23/08/2019,09:32:53,23/08/2019,09:32:53,0247 UKT 1602618043 0819/0018029        ,0.00,4000000,24119214257.29,19082300180290000020,
4182,23/08/2019,09:34:27,23/08/2019,09:34:27,0247 UKT 1209617051 0819/0008219        ,0.00,5200000,24124414257.29,19082300082190000030,
4183,23/08/2019,09:35:46,23/08/2019,09:35:46,0247 UKT 1801617054 0819/0016631        ,0.00,4000000,24128414257.29,19082300166310000012,
4184,23/08/2019,09:36:30,23/08/2019,09:36:30,0247 UKT 1208618019 0819/0013436        ,0.00,4500000,24132914257.29,19082300134360000019,
4185,23/08/2019,09:37:05,23/08/2019,09:37:05,0247 UKT 1306617019 0819/0013056        ,0.00,6200000,24139114257.29,19082300130560000004,
4186,23/08/2019,09:37:23,23/08/2019,09:37:23,0247 UKT 1313618020 0819/0013069        ,0.00,4000000,24143114257.29,19082300130690000013,
4187,23/08/2019,09:38:26,23/08/2019,09:38:26,0247 UKT 1105617027 0819/0013447        ,0.00,3900000,24147014257.29,19082300134470000006,
4188,23/08/2019,09:41:03,23/08/2019,09:41:03,0247 UKT 1107617257 0819/0005990        ,0.00,3000000,24150014257.29,19082300059900000006,
4189,23/08/2019,09:43:10,23/08/2019,09:43:10,0247 UKT 1104617025 0819/0009627        ,0.00,4000000,24154014257.29,19082300096270000022,
4190,23/08/2019,09:43:11,23/08/2019,09:43:11,0247 UKT 1305617002 0819/0016660        ,0.00,4000000,24158014257.29,19082300166600000006,
4191,23/08/2019,09:44:29,23/08/2019,09:44:29,0247 UKT 1205617088 0819/0008219        ,0.00,5900000,24163914257.29,19082300082190000032,
4192,23/08/2019,09:47:37,23/08/2019,09:47:37,0247 UKT 1604618016 0819/0008219        ,0.00,3200000,24167114257.29,19082300082190000037,
4193,23/08/2019,09:47:45,23/08/2019,09:47:45,0247 UKT 1201617066 0819/0017925        ,0.00,5400000,24172514257.29,19082300179250000015,
4194,23/08/2019,09:48:27,23/08/2019,09:48:27,0247 UKT 1203617079 0819/0010978        ,0.00,5900000,24178414257.29,19082300109780000005,
4195,23/08/2019,09:48:45,23/08/2019,09:48:45,0247 UKT 1206618026 0819/0008219        ,0.00,1000000,24179414257.29,19082300082190000039,
4196,23/08/2019,09:49:56,23/08/2019,09:49:56,0247 UKT 1211617046 0819/0008219        ,0.00,5600000,24185014257.29,19082300082190000041,
4197,23/08/2019,09:50:02,23/08/2019,09:50:02,0247 UKT 1601617051 0819/0013076        ,0.00,2700000,24187714257.29,19082300130760000026,
4198,23/08/2019,09:51:26,23/08/2019,09:51:26,0247 UKT 1106618053 0819/0011830        ,0.00,3000000,24190714257.29,19082300118300000032,
4199,23/08/2019,09:53:35,23/08/2019,09:53:35,0247 UKT 1201617075 0819/0008264        ,0.00,4000000,24194714257.29,19082300082640000035,
4200,23/08/2019,09:55:23,23/08/2019,09:55:23,0247 UKT 1601617092 0819/0013482        ,0.00,2700000,24197414257.29,19082300134820000009,
4201,23/08/2019,09:56:03,23/08/2019,09:56:03,0247 UKT 1103617077 0819/0008264        ,0.00,3000000,24200414257.29,19082300082640000037,
4202,23/08/2019,09:58:14,23/08/2019,09:58:14,0247 UKT 1302618057 0819/0011830        ,0.00,5000000,24205414257.29,19082300118300000034,
4203,23/08/2019,09:58:28,23/08/2019,09:58:28,0247 UKT 1207618044 0819/0016690        ,0.00,4500000,24209914257.29,19082300166900000036,
4204,23/08/2019,10:01:44,23/08/2019,10:01:44,0247 UKT 1208617046 0819/0016708        ,0.00,7400000,24217314257.29,19082300167080000015,
4205,23/08/2019,10:02:31,23/08/2019,10:02:31,0247 UKT                                ,0.00,5100000,24222414257.29,19082399113810145186,
4206,23/08/2019,10:03:08,23/08/2019,10:03:08,0247 UKT 1201618013 0819/0008586        ,0.00,4000000,24226414257.29,19082300085860000013,
4207,23/08/2019,10:04:06,23/08/2019,10:04:06,0247 UKT 1601617046 0819/0018179        ,0.00,4700000,24231114257.29,19082300181790000017,
4208,23/08/2019,10:04:32,23/08/2019,10:04:32,0247 UKT 1205618059 0819/0013076        ,0.00,5900000,24237014257.29,19082300130760000032,
4209,23/08/2019,10:04:40,23/08/2019,10:04:40,0247 UKT 1602618076 0819/0016629        ,0.00,5400000,24242414257.29,19082300166290000004,
4210,23/08/2019,10:04:51,23/08/2019,10:04:51,0247 UKT 1801617164 0819/0008586        ,0.00,6200000,24248614257.29,19082300085860000015,
4211,23/08/2019,10:06:08,23/08/2019,10:06:08,0247 UKT 1602618011 0819/0016629        ,0.00,5700000,24254314257.29,19082300166290000006,
4212,23/08/2019,10:07:25,23/08/2019,10:07:25,0247 UKT 1602618021 0819/0016629        ,0.00,3400000,24257714257.29,19082300166290000008,
4213,23/08/2019,10:09:03,23/08/2019,10:09:03,0247 UKT 1308618033 0819/0012239        ,0.00,10000000,24267714257.29,19082300122390000029,
4214,23/08/2019,10:11:30,23/08/2019,10:11:30,0247 UKT 1801617217 0819/0016715        ,0.00,4000000,24271714257.29,19082300167150000020,
4215,23/08/2019,10:11:55,23/08/2019,10:11:55,0247 UKT 1601618088 0819/0008594        ,0.00,500000,24272214257.29,19082300085940000004,
4216,23/08/2019,10:13:22,23/08/2019,10:13:22,0247 UKT 1801618160 0819/0008219        ,0.00,7200000,24279414257.29,19082300082190000111,
4217,23/08/2019,10:13:28,23/08/2019,10:13:28,0247 UKT 1603617144 0819/0013497        ,0.00,13000000,24292414257.29,19082300134970000035,
4218,23/08/2019,10:13:38,23/08/2019,10:13:38,0247 UKT 1203617036 0819/0016716        ,0.00,5600000,24298014257.29,19082300167160000030,
4219,23/08/2019,10:14:09,23/08/2019,10:14:09,0247 UKT                                ,0.00,6000000,24304014257.29,19082399113810253700,
4220,23/08/2019,10:14:33,23/08/2019,10:14:33,0247 UKT 1208617059 0819/0008219        ,0.00,4500000,24308514257.29,19082300082190000113,
4221,23/08/2019,10:14:59,23/08/2019,10:14:59,0247 UKT 1603618029 0819/0017974        ,0.00,6500000,24315014257.29,19082300179740000056,
4222,23/08/2019,10:15:04,23/08/2019,10:15:04,0247 UKT 1605618033 0819/0009764        ,0.00,6500000,24321514257.29,19082300097640000009,
4223,23/08/2019,10:15:26,23/08/2019,10:15:26,0247 UKT 1106617079 0819/0016999        ,0.00,3000000,24324514257.29,19082300169990000017,
4224,23/08/2019,10:16:16,23/08/2019,10:16:16,0247 UKT 1204618034 0819/0008219        ,0.00,6100000,24330614257.29,19082300082190000115,
4225,23/08/2019,10:19:25,23/08/2019,10:19:25,0247 UKT 1102617071 0819/0013482        ,0.00,6400000,24337014257.29,19082300134820000011,
4226,23/08/2019,10:19:47,23/08/2019,10:19:47,0247 UKT 1601618089 0819/0013057        ,0.00,4700000,24341714257.29,19082300130570000026,
4227,23/08/2019,10:20:55,23/08/2019,10:20:55,0247 UKT 1209617008 0819/0008236        ,0.00,6700000,24348414257.29,19082300082360000047,
4228,23/08/2019,10:25:17,23/08/2019,10:25:17,0247 UKT 1107617262 0819/0010948        ,0.00,1000000,24349414257.29,19082300109480000040,
4229,23/08/2019,10:27:31,23/08/2019,10:27:31,0247 UKT 1306617031 0819/0008574        ,0.00,6200000,24355614257.29,19082300085740000042,
4230,23/08/2019,10:28:44,23/08/2019,10:28:44,0247 UKT 1209618039 0819/0017969        ,0.00,6700000,24362314257.29,19082300179690000006,
4231,23/08/2019,10:30:32,23/08/2019,10:30:32,0247 UKT 1209617052 0819/0008219        ,0.00,5200000,24367514257.29,19082300082190000117,
4232,23/08/2019,10:33:57,23/08/2019,10:33:57,0247 UKT 1604618037 0819/0008260        ,0.00,1000000,24368514257.29,19082300082600000017,
4233,23/08/2019,10:35:32,23/08/2019,10:35:32,0247 UKT 1102617100 0819/0017009        ,0.00,5100000,24373614257.29,19082300170090000033,
4234,23/08/2019,10:36:08,23/08/2019,10:36:08,0247 UKT 1202617049 0819/0005990        ,0.00,5900000,24379514257.29,19082300059900000015,
4235,23/08/2019,10:36:25,23/08/2019,10:36:25,0247 UKT 1201618043 0819/0008219        ,0.00,6000000,24385514257.29,19082300082190000121,
4236,23/08/2019,10:36:41,23/08/2019,10:36:41,0247 UKT 1602617126 0819/0018029        ,0.00,5700000,24391214257.29,19082300180290000025,
4237,23/08/2019,10:37:59,23/08/2019,10:37:59,0247 UKT 1107617109 0819/0017359        ,0.00,3000000,24394214257.29,19082300173590000018,
4238,23/08/2019,10:39:37,23/08/2019,10:39:37,0247 UKT 1303618073 0819/0008219        ,0.00,4500000,24398714257.29,19082300082190000123,
4239,23/08/2019,10:40:00,23/08/2019,10:40:00,0247 UKT 1602617049 0819/0008594        ,0.00,4700000,24403414257.29,19082300085940000008,
4240,23/08/2019,10:40:32,23/08/2019,10:40:32,0247 UKT 1801618109 0819/0016525        ,0.00,9300000,24412714257.29,19082300165250000025,
4241,23/08/2019,10:42:03,23/08/2019,10:42:03,0247 UKT 1604618005 0819/0008219        ,0.00,1000000,24413714257.29,19082300082190000125,
4242,23/08/2019,10:42:26,23/08/2019,10:42:26,0247 UKT 1602618007 0819/0008219        ,0.00,3400000,24417114257.29,19082300082190000127,
4243,23/08/2019,10:42:50,23/08/2019,10:42:50,0247 UKT 1102617117 0819/0009627        ,0.00,5100000,24422214257.29,19082300096270000072,
4244,23/08/2019,10:44:31,23/08/2019,10:44:31,0247 UKT 1103617067 0819/0008219        ,0.00,3000000,24425214257.29,19082300082190000130,
4245,23/08/2019,10:46:30,23/08/2019,10:46:30,0247 UKT 1107617270 0819/0010443        ,0.00,5800000,24431014257.29,19082300104430000064,
4246,23/08/2019,10:46:36,23/08/2019,10:46:36,0247 UKT 1605618040 0819/0016714        ,0.00,5400000,24436414257.29,19082300167140000041,
4247,23/08/2019,10:46:46,23/08/2019,10:46:46,0247 UKT 1210618049 0819/0016619        ,0.00,6900000,24443314257.29,19082300166190000043,
4248,23/08/2019,10:47:06,23/08/2019,10:47:06,0247 UKT 1101618079 0819/0008219        ,0.00,4000000,24447314257.29,19082300082190000134,
4249,23/08/2019,10:48:22,23/08/2019,10:48:22,0247 UKT 1306618029 0819/0016587        ,0.00,6200000,24453514257.29,19082300165870000086,
4250,23/08/2019,10:48:27,23/08/2019,10:48:27,0247 UKT 1210617026 0819/0017009        ,0.00,6900000,24460414257.29,19082300170090000039,
4251,23/08/2019,10:49:17,23/08/2019,10:49:17,0247 UKT 1209618013 0819/0008219        ,0.00,500000,24460914257.29,19082300082190000136,
4252,23/08/2019,10:50:11,23/08/2019,10:50:11,0247 UKT 1107617267 0819/0016658        ,0.00,5100000,24466014257.29,19082300166580000022,
4253,23/08/2019,10:55:59,23/08/2019,10:55:59,0247 UKT                                ,0.00,6400000,24472414257.29,19082399259020625096,
4254,23/08/2019,10:56:14,23/08/2019,10:56:14,0247 UKT 1104617105 0819/0018028        ,0.00,1000000,24473414257.29,19082300180280000004,
4255,23/08/2019,10:57:54,23/08/2019,10:57:54,0247 UKT 1208618060 0819/0007367        ,0.00,6700000,24480114257.29,19082300073670000023,
4256,23/08/2019,10:58:04,23/08/2019,10:58:04,0247 UKT 1801617155 0819/0008219        ,0.00,10300000,24490414257.29,19082300082190000138,
4257,23/08/2019,10:59:13,23/08/2019,10:59:13,0247 UKT 1301617024 0819/0008219        ,0.00,3800000,24494214257.29,19082300082190000140,
4258,23/08/2019,11:01:43,23/08/2019,11:01:43,0247 UKT 1107617026 0819/0008552        ,0.00,5100000,24499314257.29,19082300085520000017,
4259,23/08/2019,11:06:15,23/08/2019,11:06:15,0247 UKT 1208618026 0819/0016705        ,0.00,6700000,24506014257.29,19082300167050000055,
4260,23/08/2019,11:07:26,23/08/2019,11:07:26,0247 UKT 1105618051 0819/0010970        ,0.00,5800000,24511814257.29,19082300109700000065,
4261,23/08/2019,11:09:10,23/08/2019,11:09:10,0247 UKT 1601617197 0819/0008594        ,0.00,500000,24512314257.29,19082300085940000012,
4262,23/08/2019,11:12:08,23/08/2019,11:12:08,0247 UKT 1603617071 0819/0007895        ,0.00,6500000,24518814257.29,19082300078950000028,
4263,23/08/2019,11:12:12,23/08/2019,11:12:12,0247 UKT 1107618153 0819/0009627        ,0.00,1000000,24519814257.29,19082300096270000083,
4264,23/08/2019,11:12:21,23/08/2019,11:12:21,0247 UKT 1303618079 0819/0017017        ,0.00,6200000,24526014257.29,19082300170170000035,
4265,23/08/2019,11:13:49,23/08/2019,11:13:49,0247 UKT 1205617046 0819/0008219        ,0.00,3900000,24529914257.29,19082300082190000144,
4266,23/08/2019,11:14:52,23/08/2019,11:14:52,0247 UKT 1210617029 0819/0013785        ,0.00,6900000,24536814257.29,19082300137850000107,
4267,23/08/2019,11:14:59,23/08/2019,11:14:59,0247 UKT 1211617015 0819/0013466        ,0.00,3700000,24540514257.29,19082300134660000030,
4268,23/08/2019,11:18:31,23/08/2019,11:18:31,0247 UKT 1208618063 0819/0008219        ,0.00,6700000,24547214257.29,19082300082190000146,
4269,23/08/2019,11:19:39,23/08/2019,11:19:39,0247 UKT 1305618010 0819/0016722        ,0.00,4000000,24551214257.29,19082300167220000018,
4270,23/08/2019,11:19:52,23/08/2019,11:19:52,0247 UKT 1208618037 0819/0008219        ,0.00,4500000,24555714257.29,19082300082190000148,
4271,23/08/2019,11:19:54,23/08/2019,11:19:54,0247 UKT 1801617251 0819/0008277        ,0.00,7200000,24562914257.29,19082300082770000079,
4272,23/08/2019,11:21:34,23/08/2019,11:21:34,0247 UKT 1105617040 0819/0017989        ,0.00,6400000,24569314257.29,19082300179890000034,
4273,23/08/2019,11:22:10,23/08/2019,11:22:10,0247 UKT 1103618042 0819/0008219        ,0.00,4000000,24573314257.29,19082300082190000150,
4274,23/08/2019,11:24:44,23/08/2019,11:24:44,0247 UKT 1210617047 0819/0016490        ,0.00,6900000,24580214257.29,19082300164900000031,
4275,23/08/2019,11:26:24,23/08/2019,11:26:24,0247 UKT 1601618061 0819/0008219        ,0.00,1000000,24581214257.29,19082300082190000152,
4276,23/08/2019,11:27:10,23/08/2019,11:27:10,0247 UKT 1306617018 0819/0017756        ,0.00,5200000,24586414257.29,19082300177560000028,
4277,23/08/2019,11:28:44,23/08/2019,11:28:44,0247 UKT 1204617046 0819/0013447        ,0.00,3900000,24590314257.29,19082300134470000027,
4278,23/08/2019,11:28:57,23/08/2019,11:28:57,0247 UKT 1307617034 0819/0007362        ,0.00,10000000,24600314257.29,19082300073620000031,
4279,23/08/2019,11:30:05,23/08/2019,11:30:05,0247 UKT 1213618012 0819/0013500        ,0.00,6200000,24606514257.29,19082300135000000011,
4280,23/08/2019,11:35:03,23/08/2019,11:35:03,0247 UKT 1103617103 0819/0010455        ,0.00,5300000,24611814257.29,19082300104550000050,
4281,23/08/2019,11:36:56,23/08/2019,11:36:56,0247 UKT 1105617062 0819/0007248        ,0.00,5100000,24616914257.29,19082300072480000064,
4282,23/08/2019,11:37:55,23/08/2019,11:37:55,0247 UKT 1206617036 0819/0017017        ,0.00,1000000,24617914257.29,19082300170170000040,
4283,23/08/2019,11:38:50,23/08/2019,11:38:50,0247 UKT 1104617097 0819/0017980        ,0.00,4700000,24622614257.29,19082300179800000030,
4284,23/08/2019,11:39:43,23/08/2019,11:39:43,0247 UKT 1101618070 0819/0011950        ,0.00,3000000,24625614257.29,19082300119500000050,
4285,23/08/2019,11:44:01,23/08/2019,11:44:01,0247 UKT 1205617028 0819/0012245        ,0.00,6400000,24632014257.29,19082300122450000072,
4286,23/08/2019,11:48:53,23/08/2019,11:48:53,0247 UKT 1801617215 0819/0011831        ,0.00,8200000,24640214257.29,19082300118310000017,
4287,23/08/2019,11:54:36,23/08/2019,11:54:36,0247 UKT 1105617073 0819/0008220        ,0.00,5100000,24645314257.29,19082300082200000012,
4288,23/08/2019,11:56:25,23/08/2019,11:56:25,0247 UKT 1211618038 0819/0007014        ,0.00,5600000,24650914257.29,19082300070140000023,
4289,23/08/2019,11:56:42,23/08/2019,11:56:42,0247 UKT 1205617057 0819/0017017        ,0.00,3900000,24654814257.29,19082300170170000043,
4290,23/08/2019,11:59:51,23/08/2019,11:59:51,0247 UKT                                ,0.00,4500000,24659314257.29,19082399048250138797,
4291,23/08/2019,12:00:21,23/08/2019,12:00:21,0247 UKT 1107617272 0819/0008177        ,0.00,4500000,24663814257.29,19082300081770000080,
4292,23/08/2019,12:14:41,23/08/2019,12:14:41,0247 UKT                                ,0.00,2700000,24666514257.29,19082399103810247477,
4293,23/08/2019,12:15:38,23/08/2019,12:15:38,0247 UKT 1201618052 0819/0013087        ,0.00,6000000,24672514257.29,19082300130870000036,
4294,23/08/2019,12:23:48,23/08/2019,12:23:48,0247 UKT                                ,0.00,4700000,24677214257.29,19082399277010310770,
4295,23/08/2019,12:29:23,23/08/2019,12:29:23,0247 UKT 1107618067 0819/0007248        ,0.00,5800000,24683014257.29,19082300072480000120,
4296,23/08/2019,12:33:50,23/08/2019,12:33:50,0247 UKT 1107617188 0819/0008555        ,0.00,5100000,24688114257.29,19082300085550000019,
4297,23/08/2019,12:39:18,23/08/2019,12:39:18,0247 UKT 1208618056 0819/0007354        ,0.00,4500000,24692614257.29,19082300073540000019,
4298,23/08/2019,12:40:15,23/08/2019,12:40:15,0247 UKT                                ,0.00,4000000,24696614257.29,19082399221010431707,
4299,23/08/2019,12:57:34,23/08/2019,12:57:34,0247 UKT 1107617112 0819/0016725        ,0.00,5100000,24701714257.29,19082300167250000016,
4300,23/08/2019,13:00:48,23/08/2019,13:00:48,0247 UKT 1210617050 0819/0007367        ,0.00,4600000,24706314257.29,19082300073670000032,
4301,23/08/2019,13:02:48,23/08/2019,13:02:48,0247 UKT 1605618042 0819/0007367        ,0.00,3200000,24709514257.29,19082300073670000034,
4302,23/08/2019,13:02:49,23/08/2019,13:02:49,0247 UKT 1801618103 0819/0007019        ,0.00,6200000,24715714257.29,19082300070190000099,
4303,23/08/2019,13:02:50,23/08/2019,13:02:50,0247 UKT 1104618041 0819/0006710        ,0.00,3000000,24718714257.29,19082300067100000029,
4304,23/08/2019,13:03:09,23/08/2019,13:03:09,0247 UKT 1602617138 0819/0007366        ,0.00,5400000,24724114257.29,19082300073660000047,
4305,23/08/2019,13:03:30,23/08/2019,13:03:30,0247 UKT 1107618083 0819/0012236        ,0.00,1000000,24725114257.29,19082300122360000026,
4306,23/08/2019,13:04:43,23/08/2019,13:04:43,0247 UKT 1208618005 0819/0007222        ,0.00,4500000,24729614257.29,19082300072220000025,
4307,23/08/2019,13:05:25,23/08/2019,13:05:25,0247 UKT 1205617080 0819/0010761        ,0.00,6400000,24736014257.29,19082300107610000116,
4308,23/08/2019,13:06:30,23/08/2019,13:06:30,0247 UKT 1308617050 0819/0013487        ,0.00,4650000,24740664257.29,19082300134870000013,
4309,23/08/2019,13:07:54,23/08/2019,13:07:54,0247 UKT 1204617032 0819/0017756        ,0.00,5900000,24746564257.29,19082300177560000033,
4310,23/08/2019,13:09:03,23/08/2019,13:09:03,0247 UKT 1203617006 0819/0008219        ,0.00,5600000,24752164257.29,19082300082190000154,
4311,23/08/2019,13:09:23,23/08/2019,13:09:23,0247 UKT 1101617097 0819/0016491        ,0.00,3000000,24755164257.29,19082300164910000068,
4312,23/08/2019,13:10:14,23/08/2019,13:10:14,0247 UKT 1602618073 0819/0008219        ,0.00,1000000,24756164257.29,19082300082190000156,
4313,23/08/2019,13:11:06,23/08/2019,13:11:06,0247 UKT 1604618012 0819/0010959        ,0.00,500000,24756664257.29,19082300109590000076,
4314,23/08/2019,13:11:46,23/08/2019,13:11:46,0247 UKT 1202617057 0819/0008219        ,0.00,3900000,24760564257.29,19082300082190000158,
4315,23/08/2019,13:12:05,23/08/2019,13:12:05,0247 UKT 1207618060 0819/0011958        ,0.00,1000000,24761564257.29,19082300119580000054,
4316,23/08/2019,13:12:49,23/08/2019,13:12:49,0247 UKT 1206617037 0819/0008219        ,0.00,4500000,24766064257.29,19082300082190000160,
4317,23/08/2019,13:13:40,23/08/2019,13:13:40,0247 UKT 1205617056 0819/0012479        ,0.00,5900000,24771964257.29,19082300124790000022,
4318,23/08/2019,13:13:44,23/08/2019,13:13:44,0247 UKT 1202617015 0819/0009612        ,0.00,3900000,24775864257.29,19082300096120000038,
4319,23/08/2019,13:15:03,23/08/2019,13:15:03,0247 UKT 1313618038 0819/0016670        ,0.00,4000000,24779864257.29,19082300166700000012,
4320,23/08/2019,13:15:07,23/08/2019,13:15:07,0247 UKT 1801617290 0819/0018015        ,0.00,6200000,24786064257.29,19082300180150000019,
4321,23/08/2019,13:16:03,23/08/2019,13:16:03,0247 UKT 1102618023 0819/0016719        ,0.00,3900000,24789964257.29,19082300167190000043,
4322,23/08/2019,13:16:21,23/08/2019,13:16:21,0247 UKT 1602617071 0819/0010443        ,0.00,5700000,24795664257.29,19082300104430000117,
4323,23/08/2019,13:16:38,23/08/2019,13:16:38,0247 UKT 1203617014 0819/0017995        ,0.00,3700000,24799364257.29,19082300179950000022,
4324,23/08/2019,13:17:25,23/08/2019,13:17:25,0247 UKT 1203617046 0819/0013446        ,0.00,3700000,24803064257.29,19082300134460000020,
4325,23/08/2019,13:17:25,23/08/2019,13:17:25,0247 UKT 1801618018 0819/0008219        ,0.00,8200000,24811264257.29,19082300082190000163,
4326,23/08/2019,13:18:51,23/08/2019,13:18:51,0247 UKT 1203617038 0819/0011814        ,0.00,5600000,24816864257.29,19082300118140000022,
4327,23/08/2019,13:18:54,23/08/2019,13:18:54,0247 UKT 1209617023 0819/0017346        ,0.00,6700000,24823564257.29,19082300173460000026,
4328,23/08/2019,13:20:10,23/08/2019,13:20:10,0247 UKT 1801617135 0819/0011958        ,0.00,8200000,24831764257.29,19082300119580000058,
4329,23/08/2019,13:20:57,23/08/2019,13:20:57,0247 UKT 1603617016 0819/0008594        ,0.00,3200000,24834964257.29,19082300085940000014,
4330,23/08/2019,13:21:41,23/08/2019,13:21:41,0247 UKT 1105618050 0819/0008219        ,0.00,5100000,24840064257.29,19082300082190000167,
4331,23/08/2019,13:23:16,23/08/2019,13:23:16,0247 UKT 1602617197 0819/0008594        ,0.00,3400000,24843464257.29,19082300085940000016,
4332,23/08/2019,13:23:16,23/08/2019,13:23:16,0247 UKT 1602617159 0819/0008219        ,0.00,4000000,24847464257.29,19082300082190000169,
4333,23/08/2019,13:24:11,23/08/2019,13:24:11,0247 UKT 1102618058 0819/0011549        ,0.00,6400000,24853864257.29,19082300115490000030,
4334,23/08/2019,13:24:33,23/08/2019,13:24:33,0247 UKT 1101618052 0819/0016441        ,0.00,5300000,24859164257.29,19082300164410000046,
4335,23/08/2019,13:24:37,23/08/2019,13:24:37,0247 UKT 1103618034 0819/0008219        ,0.00,6700000,24865864257.29,19082300082190000171,
4336,23/08/2019,13:24:38,23/08/2019,13:24:38,0247 UKT 1210618021 0819/0017012        ,0.00,1000000,24866864257.29,19082300170120000025,
4337,23/08/2019,13:24:39,23/08/2019,13:24:39,0247 UKT 1601617185 0819/0008237        ,0.00,5700000,24872564257.29,19082300082370000004,
4338,23/08/2019,13:25:02,23/08/2019,13:25:02,0247 UKT 1602618061 0819/0013497        ,0.00,1000000,24873564257.29,19082300134970000062,
4339,23/08/2019,13:25:14,23/08/2019,13:25:14,0247 UKT 1801617284 0819/0013076        ,0.00,4000000,24877564257.29,19082300130760000048,
4340,23/08/2019,13:25:44,23/08/2019,13:25:44,0247 UKT 1601617213 0819/0008237        ,0.00,2700000,24880264257.29,19082300082370000006,
4341,23/08/2019,13:26:05,23/08/2019,13:26:05,0247 UKT 1603617143 0819/0009750        ,0.00,4300000,24884564257.29,19082300097500000023,
4342,23/08/2019,13:26:52,23/08/2019,13:26:52,0247 UKT 1206618049 0819/0008219        ,0.00,7100000,24891664257.29,19082300082190000174,
4343,23/08/2019,13:27:32,23/08/2019,13:27:32,0247 UKT                                ,0.00,5900000,24897564257.29,19082399106110821707,
4344,23/08/2019,13:28:34,23/08/2019,13:28:34,0247 UKT 1103618064 0819/0008219        ,0.00,4700000,24902264257.29,19082300082190000176,
4345,23/08/2019,13:28:57,23/08/2019,13:28:57,0247 UKT 1602617068 0819/0018006        ,0.00,4700000,24906964257.29,19082300180060000033,
4346,23/08/2019,13:29:18,23/08/2019,13:29:18,0247 UKT 1206617044 0819/0008219        ,0.00,500000,24907464257.29,19082300082190000178,
4347,23/08/2019,13:30:07,23/08/2019,13:30:07,0247 UKT 1106618014 0819/0008219        ,0.00,3000000,24910464257.29,19082300082190000180,
4348,23/08/2019,13:30:32,23/08/2019,13:30:32,0247 UKT 1103618021 0819/0013057        ,0.00,3000000,24913464257.29,19082300130570000039,
4349,23/08/2019,13:31:00,23/08/2019,13:31:00,0247 UKT 1209617027 0819/0005990        ,0.00,4500000,24917964257.29,19082300059900000029,
4350,23/08/2019,13:31:05,23/08/2019,13:31:05,0247 UKT 1206618060 0819/0008219        ,0.00,4500000,24922464257.29,19082300082190000182,
4351,23/08/2019,13:32:03,23/08/2019,13:32:03,0247 UKT 1206618038 0819/0008219        ,0.00,4500000,24926964257.29,19082300082190000184,
4352,23/08/2019,13:32:31,23/08/2019,13:32:31,0247 UKT 1209618038 0819/0016485        ,0.00,4500000,24931464257.29,19082300164850000024,
4353,23/08/2019,13:32:57,23/08/2019,13:32:57,0247 UKT 1103617070 0819/0008219        ,0.00,1000000,24932464257.29,19082300082190000186,
4354,23/08/2019,13:33:55,23/08/2019,13:33:55,0247 UKT 1208617025 0819/0010761        ,0.00,1000000,24933464257.29,19082300107610000128,
4355,23/08/2019,13:34:11,23/08/2019,13:34:11,0247 UKT 1602618078 0819/0009627        ,0.00,3400000,24936864257.29,19082300096270000100,
4356,23/08/2019,13:34:14,23/08/2019,13:34:14,0247 UKT 1203617066 0819/0013066        ,0.00,3700000,24940564257.29,19082300130660000021,
4357,23/08/2019,13:34:53,23/08/2019,13:34:53,0247 UKT 1601617119 0819/0008594        ,0.00,2700000,24943264257.29,19082300085940000025,
4358,23/08/2019,13:34:57,23/08/2019,13:34:57,0247 UKT 1103618017 0819/0018000        ,0.00,6700000,24949964257.29,19082300180000000034,
4359,23/08/2019,13:36:14,23/08/2019,13:36:14,0247 UKT 1106618058 0819/0017993        ,0.00,3000000,24952964257.29,19082300179930000115,
4360,23/08/2019,13:36:18,23/08/2019,13:36:18,0247 UKT 1801618099 0819/0013469        ,0.00,4000000,24956964257.29,19082300134690000040,
4361,23/08/2019,13:36:59,23/08/2019,13:36:59,0247 UKT 1104617099 0819/0012941        ,0.00,5300000,24962264257.29,19082300129410000010,
4362,23/08/2019,13:37:01,23/08/2019,13:37:01,0247 UKT 1101618036 0819/0008219        ,0.00,6700000,24968964257.29,19082300082190000188,
4363,23/08/2019,13:38:05,23/08/2019,13:38:05,0247 UKT 1107617215 0819/0010932        ,0.00,3900000,24972864257.29,19082300109320000133,
4364,23/08/2019,13:38:07,23/08/2019,13:38:07,0247 UKT 1203617048 0819/0011802        ,0.00,4300000,24977164257.29,19082300118020000128,
4365,23/08/2019,13:38:17,23/08/2019,13:38:17,0247 UKT 1104617063 0819/0011914        ,0.00,5300000,24982464257.29,19082300119140000028,
4366,23/08/2019,13:38:25,23/08/2019,13:38:25,0247 UKT 1603617155 0819/0008219        ,0.00,3200000,24985664257.29,19082300082190000190,
4367,23/08/2019,13:38:51,23/08/2019,13:38:51,0247 UKT 1602618054 0819/0008186        ,0.00,4700000,24990364257.29,19082300081860000065,
4368,23/08/2019,13:40:39,23/08/2019,13:40:39,0247 UKT 1203617015 0819/0008219        ,0.00,3700000,24994064257.29,19082300082190000192,
4369,23/08/2019,13:40:42,23/08/2019,13:40:42,0247 UKT 1107617077 0819/0016488        ,0.00,3000000,24997064257.29,19082300164880000016,
4370,23/08/2019,13:41:17,23/08/2019,13:41:17,0247 UKT 1602617017 0819/0016647        ,0.00,2700000,24999764257.29,19082300166470000077,
4371,23/08/2019,13:42:04,23/08/2019,13:42:04,0247 UKT 1201617004 0819/0016989        ,0.00,4000000,25003764257.29,19082300169890000047,
4372,23/08/2019,13:42:39,23/08/2019,13:42:39,0247 UKT 1210617002 0819/0007897        ,0.00,4600000,25008364257.29,19082300078970000034,
4373,23/08/2019,13:42:41,23/08/2019,13:42:41,0247 UKT 1105618078 0819/0013052        ,0.00,5100000,25013464257.29,19082300130520000093,
4374,23/08/2019,13:42:45,23/08/2019,13:42:45,0247 UKT 1104617104 0819/0008594        ,0.00,5300000,25018764257.29,19082300085940000028,
4375,23/08/2019,13:43:12,23/08/2019,13:43:12,0247 UKT 1107617169 0819/0008219        ,0.00,5100000,25023864257.29,19082300082190000194,
4376,23/08/2019,13:44:19,23/08/2019,13:44:19,0247 UKT 1209617032 0819/0008219        ,0.00,1000000,25024864257.29,19082300082190000196,
4377,23/08/2019,13:44:37,23/08/2019,13:44:37,0247 UKT 1303617010 0819/0018233        ,0.00,3950000,25028814257.29,19082300182330000056,
4378,23/08/2019,13:45:03,23/08/2019,13:45:03,0247 UKT                                ,0.00,4500000,25033314257.29,19082399113810968949,
4379,23/08/2019,13:45:08,23/08/2019,13:45:08,0247 UKT 1102617111 0819/0008219        ,0.00,500000,25033814257.29,19082300082190000198,
4380,23/08/2019,13:46:06,23/08/2019,13:46:06,0247 UKT 1106618077 0819/0017969        ,0.00,5100000,25038914257.29,19082300179690000010,
4381,23/08/2019,13:46:52,23/08/2019,13:46:52,0247 UKT 1211617053 0819/0017017        ,0.00,5600000,25044514257.29,19082300170170000063,
4382,23/08/2019,13:47:49,23/08/2019,13:47:49,0247 UKT 1105618043 0819/0008219        ,0.00,6400000,25050914257.29,19082300082190000200,
4383,23/08/2019,13:48:04,23/08/2019,13:48:04,0247 UKT 1801617138 0819/0017012        ,0.00,8200000,25059114257.29,19082300170120000029,
4384,23/08/2019,13:48:56,23/08/2019,13:48:56,0247 UKT 1301617062 0819/0008219        ,0.00,6000000,25065114257.29,19082300082190000202,
4385,23/08/2019,13:49:28,23/08/2019,13:49:28,0247 UKT 1101617106 0819/0005990        ,0.00,5300000,25070414257.29,19082300059900000033,
4386,23/08/2019,13:49:36,23/08/2019,13:49:36,0247 UKT 1102617036 0819/0008951        ,0.00,3000000,25073414257.29,19082300089510000031,
4387,23/08/2019,13:51:36,23/08/2019,13:51:36,0247 UKT 1602617153 0819/0005990        ,0.00,4000000,25077414257.29,19082300059900000035,
4388,23/08/2019,13:51:46,23/08/2019,13:51:46,0247 UKT 1107617116 0819/0008574        ,0.00,5100000,25082514257.29,19082300085740000067,
4389,23/08/2019,13:53:28,23/08/2019,13:53:28,0247 UKT 1602618028 0819/0013470        ,0.00,1000000,25083514257.29,19082300134700000066,
4390,23/08/2019,13:53:32,23/08/2019,13:53:32,0247 UKT                                ,0.00,5600000,25089114257.29,19082399113810039623,
4391,23/08/2019,13:54:44,23/08/2019,13:54:44,0247 UKT                                ,0.00,6700000,25095814257.29,19082399113810049977,
4392,23/08/2019,13:55:01,23/08/2019,13:55:01,0247 UKT 1209618015 0819/0016663        ,0.00,4500000,25100314257.29,19082300166630000032,
4393,23/08/2019,13:56:16,23/08/2019,13:56:16,0247 UKT 1205618030 0819/0008219        ,0.00,3900000,25104214257.29,19082300082190000204,
4394,23/08/2019,13:57:16,23/08/2019,13:57:16,0247 UKT 1107618158 0819/0013056        ,0.00,3000000,25107214257.29,19082300130560000023,
4395,23/08/2019,13:57:49,23/08/2019,13:57:49,0247 UKT                                ,0.00,6200000,25113414257.29,19082399114110076385,
4396,23/08/2019,13:58:19,23/08/2019,13:58:19,0247 UKT                                ,0.00,4000000,25117414257.29,19082399035160080500,
4397,23/08/2019,13:58:38,23/08/2019,13:58:38,0247 UKT 1101618045 0819/0008214        ,0.00,3000000,25120414257.29,19082300082140000023,
4398,23/08/2019,13:58:42,23/08/2019,13:58:42,0247 UKT 1104617061 0819/0008219        ,0.00,3000000,25123414257.29,19082300082190000208,
4399,23/08/2019,13:58:58,23/08/2019,13:58:58,0247 UKT 1104618014 0819/0018015        ,0.00,3000000,25126414257.29,19082300180150000021,
4400,23/08/2019,14:00:27,23/08/2019,14:00:27,0247 UKT                                ,0.00,4500000,25130914257.29,19082399113810098435,
4401,23/08/2019,14:00:53,23/08/2019,14:00:53,0247 UKT 1107617138 0819/0007348        ,0.00,3000000,25133914257.29,19082300073480000095,
4402,23/08/2019,14:01:37,23/08/2019,14:01:37,0247 UKT 1107618043 0819/0016529        ,0.00,3000000,25136914257.29,19082300165290000118,
4403,23/08/2019,14:02:08,23/08/2019,14:02:08,0247 UKT 1304617076 0819/0007759        ,0.00,3950000,25140864257.29,19082300077590000053,
4404,23/08/2019,14:02:08,23/08/2019,14:02:08,0247 UKT 1801618171 0819/0013497        ,0.00,6200000,25147064257.29,19082300134970000069,
4405,23/08/2019,14:03:16,23/08/2019,14:03:16,0247 UKT 1202617047 0819/0009593        ,0.00,3900000,25150964257.29,19082300095930000042,
4406,23/08/2019,14:05:11,23/08/2019,14:05:11,0247 UKT 1602617201 0819/0008219        ,0.00,9400000,25160364257.29,19082300082190000211,
4407,23/08/2019,14:05:37,23/08/2019,14:05:37,0247 UKT 1211617036 0819/0013491        ,0.00,5000000,25165364257.29,19082300134910000054,
4408,23/08/2019,14:05:48,23/08/2019,14:05:48,0247 UKT 1102618020 0819/0007901        ,0.00,6400000,25171764257.29,19082300079010000026,
4409,23/08/2019,14:06:22,23/08/2019,14:06:22,0247 UKT 1603617121 0819/0008214        ,0.00,3200000,25174964257.29,19082300082140000027,
4410,23/08/2019,14:07:00,23/08/2019,14:07:00,0247 UKT 1603617096 0819/0008594        ,0.00,3200000,25178164257.29,19082300085940000030,
4411,23/08/2019,14:07:22,23/08/2019,14:07:22,0247 UKT 1605618035 0819/0008214        ,0.00,1000000,25179164257.29,19082300082140000029,
4412,23/08/2019,14:07:44,23/08/2019,14:07:44,0247 UKT 1306617020 0819/0016441        ,0.00,4000000,25183164257.29,19082300164410000071,
4413,23/08/2019,14:07:58,23/08/2019,14:07:58,0247 UKT 1206618054 0819/0011939        ,0.00,500000,25183664257.29,19082300119390000041,
4414,23/08/2019,14:08:04,23/08/2019,14:08:04,0247 UKT 1801618172 0819/0016439        ,0.00,6200000,25189864257.29,19082300164390000034,
4415,23/08/2019,14:08:23,23/08/2019,14:08:23,0247 UKT 1206617026 0819/0017978        ,0.00,5200000,25195064257.29,19082300179780000064,
4416,23/08/2019,14:09:09,23/08/2019,14:09:09,0247 UKT 1105618061 0819/0012246        ,0.00,5100000,25200164257.29,19082300122460000055,
4417,23/08/2019,14:10:47,23/08/2019,14:10:47,0247 UKT 1206617045 0819/0011939        ,0.00,500000,25200664257.29,19082300119390000043,
4418,23/08/2019,14:11:04,23/08/2019,14:11:04,0247 UKT                                ,0.00,3700000,25204364257.29,19082399113810188200,
4419,23/08/2019,14:11:47,23/08/2019,14:11:47,0247 UKT 1301618031 0819/0008219        ,0.00,6000000,25210364257.29,19082300082190000213,
4420,23/08/2019,14:13:16,23/08/2019,14:13:16,0247 UKT 1209617060 0819/0011958        ,0.00,6700000,25217064257.29,19082300119580000075,
4421,23/08/2019,14:13:57,23/08/2019,14:13:57,0247 UKT 1208617023 0819/0008219        ,0.00,500000,25217564257.29,19082300082190000215,
4422,23/08/2019,14:13:57,23/08/2019,14:13:57,0247 UKT 1603617134 0819/0016612        ,0.00,5400000,25222964257.29,19082300166120000061,
4423,23/08/2019,14:15:07,23/08/2019,14:15:07,0247 UKT 1213617010 0819/0008219        ,0.00,3700000,25226664257.29,19082300082190000217,
4424,23/08/2019,14:16:08,23/08/2019,14:16:08,0247 UKT 1308618018 0819/0008225        ,0.00,6250000,25232914257.29,19082300082250000043,
4425,23/08/2019,14:16:09,23/08/2019,14:16:09,0247 UKT 1106618076 0819/0012937        ,0.00,5100000,25238014257.29,19082300129370000014,
4426,23/08/2019,14:16:47,23/08/2019,14:16:47,0247 UKT 1107617030 0819/0008219        ,0.00,3000000,25241014257.29,19082300082190000219,
4427,23/08/2019,14:17:57,23/08/2019,14:17:57,0247 UKT 1102617057 0819/0017966        ,0.00,5100000,25246114257.29,19082300179660000038,
4428,23/08/2019,14:20:16,23/08/2019,14:20:16,0247 UKT 1104617103 0819/0011547        ,0.00,4700000,25250814257.29,19082300115470000134,
4429,23/08/2019,14:20:38,23/08/2019,14:20:38,0247 UKT 1602618063 0819/0016545        ,0.00,3400000,25254214257.29,19082300165450000132,
4430,23/08/2019,14:20:49,23/08/2019,14:20:49,0247 UKT 1105617046 0819/0007897        ,0.00,5100000,25259314257.29,19082300078970000041,
4431,23/08/2019,14:21:11,23/08/2019,14:21:11,0247 UKT 1204617044 0819/0008219        ,0.00,3900000,25263214257.29,19082300082190000221,
4432,23/08/2019,14:21:52,23/08/2019,14:21:52,0247 UKT 1209617029 0819/0012937        ,0.00,6700000,25269914257.29,19082300129370000018,
4433,23/08/2019,14:22:20,23/08/2019,14:22:20,0247 UKT 1305618028 0819/0008219        ,0.00,4500000,25274414257.29,19082300082190000223,
4434,23/08/2019,14:22:45,23/08/2019,14:22:45,0247 UKT 1107617236 0819/0018138        ,0.00,3000000,25277414257.29,19082300181380000045,
4435,23/08/2019,14:22:47,23/08/2019,14:22:47,0247 UKT 1801618153 0819/0011830        ,0.00,6200000,25283614257.29,19082300118300000097,
4436,23/08/2019,14:24:58,23/08/2019,14:24:58,0247 UKT 1603617157 0819/0013060        ,0.00,5400000,25289014257.29,19082300130600000024,
4437,23/08/2019,14:25:39,23/08/2019,14:25:39,0247 UKT 1602617124 0819/0011952        ,0.00,4000000,25293014257.29,19082300119520000070,
4438,23/08/2019,14:27:01,23/08/2019,14:27:01,0247 UKT 1801618092 0819/0011830        ,0.00,4000000,25297014257.29,19082300118300000099,
4439,23/08/2019,14:27:09,23/08/2019,14:27:09,0247 UKT 1601617203 0819/0017995        ,0.00,4700000,25301714257.29,19082300179950000041,
4440,23/08/2019,14:27:48,23/08/2019,14:27:48,0247 UKT 1101617098 0819/0011952        ,0.00,5300000,25307014257.29,19082300119520000072,
4441,23/08/2019,14:27:49,23/08/2019,14:27:49,0247 UKT 1305618035 0819/0008219        ,0.00,6200000,25313214257.29,19082300082190000225,
4442,23/08/2019,14:32:47,23/08/2019,14:32:47,0247 UKT 1101618060 0819/0017790        ,0.00,5300000,25318514257.29,19082300177900000087,
4443,23/08/2019,14:34:32,23/08/2019,14:34:32,0247 UKT 1104618047 0819/0017993        ,0.00,4700000,25323214257.29,19082300179930000152,
4444,23/08/2019,14:36:19,23/08/2019,14:36:19,0247 UKT 1210618067 0819/0008219        ,0.00,4600000,25327814257.29,19082300082190000227,
4445,23/08/2019,14:37:16,23/08/2019,14:37:16,0247 UKT 1105617029 0819/0008219        ,0.00,5100000,25332914257.29,19082300082190000229,
4446,23/08/2019,14:39:03,23/08/2019,14:39:03,0247 UKT 1107617239 0819/0008219        ,0.00,3000000,25335914257.29,19082300082190000231,
4447,23/08/2019,14:39:52,23/08/2019,14:39:52,0247 UKT 1602617161 0819/0008594        ,0.00,1000000,25336914257.29,19082300085940000036,
4448,23/08/2019,14:40:41,23/08/2019,14:40:41,0247 UKT 1102618001 0819/0008594        ,0.00,500000,25337414257.29,19082300085940000038,
4449,23/08/2019,14:40:50,23/08/2019,14:40:50,0247 CUT 1604618007 0819/0008219        ,0.00,500000,25337914257.29,19082300082190000233,
4450,23/08/2019,14:41:45,23/08/2019,14:41:45,0247 UKT 1313617025 0819/0008594        ,0.00,6200000,25344114257.29,19082300085940000040,
4451,23/08/2019,14:42:08,23/08/2019,14:42:08,0247 UKT 1106617024 0819/0008219        ,0.00,5100000,25349214257.29,19082300082190000235,
4452,23/08/2019,14:42:34,23/08/2019,14:42:34,0247 UKT 1307617031 0819/0016437        ,0.00,6250000,25355464257.29,19082300164370000070,
4453,23/08/2019,14:44:30,23/08/2019,14:44:30,0247 UKT 1101617075 0819/0008219        ,0.00,4000000,25359464257.29,19082300082190000237,
4454,23/08/2019,14:45:09,23/08/2019,14:45:09,0247 UKT 1205618104 0819/0013497        ,0.00,5900000,25365364257.29,19082300134970000082,
4455,23/08/2019,14:45:56,23/08/2019,14:45:56,0247 UKT 1210618063 0819/0008219        ,0.00,6900000,25372264257.29,19082300082190000239,
4456,23/08/2019,14:47:27,23/08/2019,14:47:27,0247 UKT 1209617050 0819/0008219        ,0.00,1000000,25373264257.29,19082300082190000241,
4457,23/08/2019,14:48:08,23/08/2019,14:48:08,0247 UKT 1202617044 0819/0008225        ,0.00,3900000,25377164257.29,19082300082250000050,
4458,23/08/2019,14:48:35,23/08/2019,14:48:35,0247 UKT 1206617040 0819/0008219        ,0.00,6700000,25383864257.29,19082300082190000243,
4459,23/08/2019,14:48:52,23/08/2019,14:48:52,0247 UKT 1801617202 0819/0011830        ,0.00,4000000,25387864257.29,19082300118300000105,
4460,23/08/2019,14:48:58,23/08/2019,14:48:58,0247 UKT 1102618054 0819/0008951        ,0.00,3900000,25391764257.29,19082300089510000043,
4461,23/08/2019,14:49:00,23/08/2019,14:49:00,0247 UKT 1102617070 0819/0010462        ,0.00,3000000,25394764257.29,19082300104620000052,
4462,23/08/2019,14:49:24,23/08/2019,14:49:24,0247 UKT 1204617040 0819/0008574        ,0.00,3900000,25398664257.29,19082300085740000094,
4463,23/08/2019,14:49:36,23/08/2019,14:49:36,0247 UKT 1105617038 0819/0008219        ,0.00,500000,25399164257.29,19082300082190000245,
4464,23/08/2019,14:50:36,23/08/2019,14:50:36,0247 UKT 1104618035 0819/0008219        ,0.00,5300000,25404464257.29,19082300082190000247,
4465,23/08/2019,14:50:47,23/08/2019,14:50:47,0247 UKT 1107617120 0819/0011958        ,0.00,3000000,25407464257.29,19082300119580000088,
4466,23/08/2019,14:51:36,23/08/2019,14:51:36,0247 UKT 1104618053 0819/0008219        ,0.00,4000000,25411464257.29,19082300082190000249,
4467,23/08/2019,14:52:10,23/08/2019,14:52:10,0247 UKT 1205617048 0819/0012239        ,0.00,3900000,25415364257.29,19082300122390000060,
4468,23/08/2019,14:52:51,23/08/2019,14:52:51,0247 UKT 1601617111 0819/0006664        ,0.00,3400000,25418764257.29,19082300066640000038,
4469,23/08/2019,14:53:44,23/08/2019,14:53:44,0247 UKT 1605618025 0819/0016999        ,0.00,6500000,25425264257.29,19082300169990000070,
4470,23/08/2019,14:55:02,23/08/2019,14:55:02,0247 UKT 1205617077 0819/0008219        ,0.00,3900000,25429164257.29,19082300082190000251,
4471,23/08/2019,14:57:44,23/08/2019,14:57:44,0247 UKT 1205617112 0819/0008219        ,0.00,5900000,25435064257.29,19082300082190000253,
4472,23/08/2019,14:58:11,23/08/2019,14:58:11,0247 UKT 1203617077 0819/0011958        ,0.00,5600000,25440664257.29,19082300119580000095,
4473,23/08/2019,14:58:31,23/08/2019,14:58:31,0247 UKT 1213617020 0819/0008214        ,0.00,3700000,25444364257.29,19082300082140000039,
4474,23/08/2019,14:59:15,23/08/2019,14:59:15,0247 UKT                                ,0.00,4500000,25448864257.29,19082399113810590023,
4475,23/08/2019,15:00:06,23/08/2019,15:00:06,0247 UKT 1304617072 0819/0008219        ,0.00,1000000,25449864257.29,19082300082190000255,
4476,23/08/2019,15:06:38,23/08/2019,15:06:38,0247 UKT                                ,0.00,1000000,25450864257.29,19082399113810653350,
4477,23/08/2019,15:07:26,23/08/2019,15:07:26,0247 UKT 1602618069 0819/0012489        ,0.00,4700000,25455564257.29,19082300124890000164,
4478,23/08/2019,15:07:27,23/08/2019,15:07:27,0247 UKT 1101617111 0819/0017478        ,0.00,5300000,25460864257.29,19082300174780000260,
4479,23/08/2019,15:10:22,23/08/2019,15:10:22,0247 UKT                                ,0.00,6250000,25467114257.29,19082399016020685063,
4480,23/08/2019,15:11:06,23/08/2019,15:11:06,0247 UKT 1205617115 0819/0008219        ,0.00,3900000,25471014257.29,19082300082190000260,
4481,23/08/2019,15:12:07,23/08/2019,15:12:07,0247 UKT 1604618050 0819/0008219        ,0.00,3200000,25474214257.29,19082300082190000262,
4482,23/08/2019,15:19:41,23/08/2019,15:19:41,0247 UKT 1207618034 0819/0006664        ,0.00,4500000,25478714257.29,19082300066640000041,
4483,23/08/2019,15:24:15,23/08/2019,15:24:15,0247 UKT 1206617049 0819/0017003        ,0.00,7400000,25486114257.29,19082300170030000058,
4484,23/08/2019,15:32:33,23/08/2019,15:32:33,0247 UKT 1602617144 0819/0008219        ,0.00,2700000,25488814257.29,19082300082190000265,
4485,23/08/2019,15:36:21,23/08/2019,15:36:21,0247 UKT 1602617051 0819/0008219        ,0.00,4700000,25493514257.29,19082300082190000267,
4486,23/08/2019,15:44:53,23/08/2019,15:44:53,0247 UKT                                ,0.00,6250000,25499764257.29,19082399113810183920,
4487,23/08/2019,17:44:48,23/08/2019,17:44:48,0247 UKT                                ,0.00,3800000,25503564257.29,19082399121110520908,
4488,23/08/2019,18:18:19,23/08/2019,18:18:19,0247 UKT                                ,0.00,4500000,25508064257.29,19082399569010782089,
4489,23/08/2019,19:01:42,23/08/2019,19:01:42,0247 UKT                                ,0.00,3000000,25511064257.29,19082399401010140676,
4490,23/08/2019,19:12:15,23/08/2019,19:12:15,0247 UKT                                ,0.00,4500000,25515564257.29,19082399113810227971,
4491,23/08/2019,19:45:11,23/08/2019,19:45:11,0247 UKT                                ,0.00,5100000,25520664257.29,19082399614010495213,
4492,23/08/2019,21:24:39,23/08/2019,21:24:39,0247 UKT                                ,0.00,3900000,25524564257.29,19082399048180181766,
4493,23/08/2019,21:44:20,23/08/2019,21:44:20,0247 UKT                                ,0.00,4500000,25529064257.29,19082399379060284221,
4494,23/08/2019,21:54:38,23/08/2019,21:54:38,0247 UKT                                ,0.00,3700000,25532764257.29,19082399676010336798,
4495,23/08/2019,22:53:06,23/08/2019,22:53:06,0247 UKT                                ,0.00,3000000,25535764257.29,19082399120010632300,
4496,26/08/2019,09:15:32,26/08/2019,09:15:32,0247 UKT 1603617060 0819/0011958        ,0.00,3200000,25538964257.29,19082600119580000035,
4497,28/08/2019,09:10:35,28/08/2019,09:10:35,0247 UKT 1204617057 0819/0008219        ,0.00,500000,25539464257.29,19082800082190000005,
4498,28/08/2019,09:52:07,28/08/2019,09:52:07,0247 SPU 1939219012366 0819/0008219     ,0.00,800000,25540264257.29,19082800082190000007,
4499,29/08/2019,08:15:42,29/08/2019,08:15:42,211/M494/CMF/VIII/PENGEMBLIAN DANA UKT  ,5300000,0.00,25534964257.29,19082900171770000005,
4500,31/08/2019,00:00:00,31/08/2019,00:00:00,Bunga Rekening                          ,0.00,29502796.88,25564467054.17,19083144000720085663,
4501,31/08/2019,00:00:01,31/08/2019,00:00:01,DR 0021101400167786 KE 0021101300006585 ,0.00,52658060.82,25617125114.99,19083163000071      ,
Total per 31/08/2019,,,,,,"5,005,300,000.00","20,046,814,857.00"
Grand total per 31/08/2019,,,,,,"5,005,300,000.00","20,046,814,857.00"


User ID:,BPNUNJ
User Name:,BENDAHARA PENERIMA
Download Time:,02-09-2019 07:41:50
